,Num,Chr,Start,Stop,Crossover_sites,Size
0,3482183,1,2175658,2176007,2175832,349
1,3482183,1,16076463,16077180,16076821,717
2,3482183,1,20137624,20137661,20137642,37
3,3482183,1,24821380,24821764,24821572,384
4,3482183,2,1451259,1451558,1451408,299
5,3482183,2,12486096,12487665,12486880,1569
6,3482183,2,19095896,19098525,19097210,2629
7,3482183,3,1584447,1584736,1584591,289
8,3482183,3,11916698,11916899,11916798,201
9,3482183,3,12773212,12773779,12773495,567
10,3482183,3,16914556,16914995,16914775,439
11,3482183,4,14865024,14865120,14865072,96
12,3482183,5,1677946,1679252,1678599,1306
13,3482184,1,4120891,4121964,4121427,1073
14,3482184,1,11836873,11836904,11836888,31
15,3482184,1,20386138,20387177,20386657,1039
16,3482184,1,26554279,26559548,26556913,5269
17,3482184,2,9676027,9676168,9676097,141
18,3482184,3,5167887,5177902,5172894,10015
19,3482184,3,16770225,16770704,16770464,479
20,3482184,4,9198038,9198450,9198244,412
21,3482184,5,7900780,7901205,7900992,425
22,3482184,5,8761113,8761188,8761150,75
23,3482184,5,25848401,25848921,25848661,520
24,3482185,1,29183103,29183540,29183321,437
25,3482185,2,400106,400873,400489,767
26,3482185,5,1148818,1149567,1149192,749
27,3482185,5,22940121,22942327,22941224,2206
28,3482186,1,25009266,25009297,25009281,31
29,3482186,2,8557284,8557420,8557352,136
30,3482186,2,9237745,9237928,9237836,183
31,3482186,4,11916414,11916736,11916575,322
32,3482186,5,19986694,19986803,19986748,109
33,3482186,5,25717850,25718329,25718089,479
34,3482187,1,17222425,17222746,17222585,321
35,3482187,2,12396335,12396983,12396659,648
36,3482187,3,16429059,16430773,16429916,1714
37,3482187,4,5436414,5436471,5436442,57
38,3482187,4,5602478,5602487,5602482,9
39,3482187,4,16654936,16655456,16655196,520
40,3482187,5,4774850,4775323,4775086,473
41,3482188,2,1025098,1025193,1025145,95
42,3482188,2,8410904,8411166,8411035,262
43,3482188,3,1253523,1254197,1253860,674
44,3482188,3,9486269,9486878,9486573,609
45,3482188,3,18782198,18782594,18782396,396
46,3482188,5,6517296,6517868,6517582,572
47,3482188,5,8733909,8734828,8734368,919
48,3482189,1,563035,563367,563201,332
49,3482189,1,4032592,4032619,4032605,27
50,3482189,1,8452972,8452981,8452976,9
51,3482189,1,18908304,18908314,18908309,10
52,3482189,1,23083383,23083702,23083542,319
53,3482189,4,5299202,5299360,5299281,158
54,3482189,4,8070436,8070506,8070471,70
55,3482189,4,14728014,14728108,14728061,94
56,3482189,5,832598,833410,833004,812
57,3482189,5,2799020,2801843,2800431,2823
58,3482190,1,7716292,7722780,7719536,6488
59,3482190,1,29833343,29833712,29833527,369
60,3482190,3,15359236,15360391,15359813,1155
61,3482190,4,8896158,8896292,8896225,134
62,3482190,4,9756735,9757743,9757239,1008
63,3482190,5,20942143,20943406,20942774,1263
64,3482190,5,21601855,21602221,21602038,366
65,3482191,1,19831215,19832907,19832061,1692
66,3482191,2,10829545,10829650,10829597,105
67,3482191,3,2009810,2009870,2009840,60
68,3482191,3,19270241,19270484,19270362,243
69,3482191,3,20294217,20296434,20295325,2217
70,3482191,4,5434236,5435661,5434948,1425
71,3482191,5,3046539,3046628,3046583,89
72,3482191,5,8182628,8183225,8182926,597
73,3482192,1,6919637,6920638,6920137,1001
74,3482192,1,18203503,18203545,18203524,42
75,3482192,2,988712,988844,988778,132
76,3482192,2,5976799,5977456,5977127,657
77,3482192,3,6465778,6465929,6465853,151
78,3482192,4,723145,723825,723485,680
79,3482192,5,1352194,1352732,1352463,538
80,3482192,5,16840930,16841688,16841309,758
81,3482192,5,24735914,24736097,24736005,183
82,3482193,1,2759388,2760302,2759845,914
83,3482193,1,11859371,11860092,11859731,721
84,3482193,1,22513872,22515902,22514887,2030
85,3482193,2,14824618,14840285,14832451,15667
86,3482193,4,128068,128981,128524,913
87,3482193,4,1524434,1524894,1524664,460
88,3482193,4,18035787,18036087,18035937,300
89,3482193,5,4652075,4652353,4652214,278
90,3482193,5,26763982,26764716,26764349,734
91,3482194,1,16670391,16673084,16671737,2693
92,3482194,2,9395971,9396237,9396104,266
93,3482194,2,11814826,11815201,11815013,375
94,3482194,3,16925149,16925472,16925310,323
95,3482194,4,7463965,7465037,7464501,1072
96,3482194,4,15396258,15397197,15396727,939
97,3482194,5,524999,525347,525173,348
98,3482194,5,18322744,18325005,18323874,2261
99,3482195,1,1953198,1953448,1953323,250
100,3482195,1,7251207,7251711,7251459,504
101,3482195,2,17711336,17711382,17711359,46
102,3482195,4,11733692,11733885,11733788,193
103,3482195,4,17370694,17371540,17371117,846
104,3482196,1,5626425,5626495,5626460,70
105,3482196,2,1870700,1870942,1870821,242
106,3482196,3,1911270,1911817,1911543,547
107,3482196,3,8930056,8930592,8930324,536
108,3482196,3,11216696,11220568,11218632,3872
109,3482196,4,7433442,7433854,7433648,412
110,3482196,4,11902990,11903208,11903099,218
111,3482196,4,14420203,14420309,14420256,106
112,3482196,5,17809746,17809796,17809771,50
113,3482197,1,2034853,2035211,2035032,358
114,3482197,1,7079617,7080553,7080085,936
115,3482197,1,16938080,16939636,16938858,1556
116,3482197,1,25466318,25466638,25466478,320
117,3482197,1,26324237,26324339,26324288,102
118,3482197,3,11732713,11732809,11732761,96
119,3482197,3,20602120,20603229,20602674,1109
120,3482197,5,1076546,1078099,1077322,1553
121,3482198,1,90809,90864,90836,55
122,3482198,1,26673266,26674631,26673948,1365
123,3482198,2,6243040,6244110,6243575,1070
124,3482198,3,3883542,3886666,3885104,3124
125,3482198,3,11732809,11732824,11732816,15
126,3482198,4,249498,250918,250208,1420
127,3482198,4,459662,460326,459994,664
128,3482198,5,2697276,2697607,2697441,331
129,3482198,5,19150090,19150724,19150407,634
130,3482199,1,21062794,21062800,21062797,6
131,3482199,2,6777565,6777769,6777667,204
132,3482199,2,11447793,11450066,11448929,2273
133,3482199,5,6675058,6675975,6675516,917
134,3482199,5,26852891,26853204,26853047,313
135,3482200,2,800062,800847,800454,785
136,3482200,2,10429019,10429100,10429059,81
137,3482200,3,1753277,1755396,1754336,2119
138,3482200,4,317129,317922,317525,793
139,3482200,4,5426726,5427017,5426871,291
140,3482200,5,10453454,10454682,10454068,1228
141,3482200,5,16963791,16963863,16963827,72
142,3482201,1,17321489,17321579,17321534,90
143,3482201,1,24753491,24753571,24753531,80
144,3482201,2,1005928,1006608,1006268,680
145,3482201,2,10459135,10459597,10459366,462
146,3482201,3,7817475,7817586,7817530,111
147,3482201,3,10185751,10185861,10185806,110
148,3482201,3,18802435,18804021,18803228,1586
149,3482201,4,10327044,10327835,10327439,791
150,3482201,5,6414078,6414363,6414220,285
151,3482201,5,23793906,23794242,23794074,336
152,3482202,1,468404,469548,468976,1144
153,3482202,1,29570034,29570221,29570127,187
154,3482202,2,484129,484672,484400,543
155,3482202,2,11776311,11776419,11776365,108
156,3482202,3,8193187,8193832,8193509,645
157,3482202,3,17550449,17551986,17551217,1537
158,3482202,4,841423,841448,841435,25
159,3482202,5,2352778,2352828,2352803,50
160,3482202,5,7757958,7759735,7758846,1777
161,3482203,1,20930313,20930364,20930338,51
162,3482203,1,25648968,25649213,25649090,245
163,3482203,2,18750754,18753033,18751893,2279
164,3482203,3,617383,618423,617903,1040
165,3482203,3,21913459,21913506,21913482,47
166,3482203,4,250955,253125,252040,2170
167,3482203,4,6855561,6855771,6855666,210
168,3482203,5,5230125,5230830,5230477,705
169,3482203,5,9038383,9040418,9039400,2035
170,3482203,5,9969746,9970298,9970022,552
171,3482203,5,23231481,23233151,23232316,1670
172,3482204,1,30156853,30157945,30157399,1092
173,3482204,2,10380524,10380814,10380669,290
174,3482204,3,335510,335661,335585,151
175,3482204,3,9837747,9837876,9837811,129
176,3482204,4,6025688,6025835,6025761,147
177,3482204,4,8961980,8963123,8962551,1143
178,3482204,5,9010804,9011642,9011223,838
179,3482205,1,8544508,8546108,8545308,1600
180,3482205,1,24495936,24496851,24496393,915
181,3482205,2,2087623,2089521,2088572,1898
182,3482205,2,2180734,2181177,2180955,443
183,3482205,2,18961223,18961510,18961366,287
184,3482205,3,1775609,1776074,1775841,465
185,3482205,3,22811599,22813034,22812316,1435
186,3482205,4,1023562,1026302,1024932,2740
187,3482205,4,18336714,18336724,18336719,10
188,3482205,5,4216504,4217338,4216921,834
189,3482205,5,16656862,16656954,16656908,92
190,3482205,5,22585300,22587695,22586497,2395
191,3482206,1,13025945,13033405,13029675,7460
192,3482206,2,19261210,19263042,19262126,1832
193,3482206,3,3132699,3133082,3132890,383
194,3482206,5,8870935,8875281,8873108,4346
195,3482207,1,12735601,12735621,12735611,20
196,3482207,2,8403872,8403915,8403893,43
197,3482207,3,11289469,11290219,11289844,750
198,3482208,1,9916833,9917548,9917190,715
199,3482208,1,9984971,9985317,9985144,346
200,3482208,1,24547887,24547927,24547907,40
201,3482208,1,28413929,28414098,28414013,169
202,3482208,2,7284809,7284846,7284827,37
203,3482208,2,18799212,18799354,18799283,142
204,3482208,3,1952476,1953139,1952807,663
205,3482208,3,11163570,11163834,11163702,264
206,3482208,4,15619664,15623182,15621423,3518
207,3482208,5,124411,124706,124558,295
208,3482209,1,1839052,1839746,1839399,694
209,3482209,1,7908035,7908199,7908117,164
210,3482209,1,17303972,17305007,17304489,1035
211,3482209,1,28860968,28861293,28861130,325
212,3482209,2,93778,94141,93959,363
213,3482209,2,5834498,5835480,5834989,982
214,3482209,2,6480928,6481791,6481359,863
215,3482209,3,6281816,6282200,6282008,384
216,3482209,3,8283038,8283635,8283336,597
217,3482209,4,9727734,9728291,9728012,557
218,3482209,4,14973544,14973985,14973764,441
219,3482209,5,14936739,14937324,14937031,585
220,3482209,5,17240007,17241534,17240770,1527
221,3482210,1,3234313,3234393,3234353,80
222,3482210,1,21914955,21916357,21915656,1402
223,3482210,2,5731800,5732557,5732178,757
224,3482210,2,17437485,17439085,17438285,1600
225,3482210,3,5577559,5578064,5577811,505
226,3482210,3,16056085,16056087,16056086,2
227,3482210,4,15654653,15655286,15654969,633
228,3482210,5,6837250,6838256,6837753,1006
229,3482210,5,20762914,20763389,20763151,475
230,3482210,5,26912547,26913253,26912900,706
231,3482211,2,8249725,8249941,8249833,216
232,3482211,5,2451462,2451940,2451701,478
233,3482212,1,11091483,11091638,11091560,155
234,3482212,1,24372194,24373890,24373042,1696
235,3482212,2,8089573,8089980,8089776,407
236,3482212,3,7909774,7915894,7912834,6120
237,3482212,3,18293804,18294373,18294088,569
238,3482212,3,18875141,18876025,18875583,884
239,3482212,5,3080741,3081024,3080882,283
240,3482212,5,8580048,8580851,8580449,803
241,3482214,1,20533448,20534398,20533923,950
242,3482214,1,29366447,29366535,29366491,88
243,3482214,2,5535187,5535447,5535317,260
244,3482214,3,10142871,10143187,10143029,316
245,3482214,4,395972,396105,396038,133
246,3482214,4,5379241,5379455,5379348,214
247,3482214,4,17419577,17420836,17420206,1259
248,3482214,5,732614,732968,732791,354
249,3482215,2,422199,422967,422583,768
250,3482215,2,1419643,1419752,1419697,109
251,3482215,3,3348097,3350888,3349492,2791
252,3482215,3,10651235,10651498,10651366,263
253,3482215,3,18098971,18099156,18099063,185
254,3482215,4,721660,721726,721693,66
255,3482215,4,5712279,5712609,5712444,330
256,3482215,4,12513125,12514093,12513609,968
257,3482215,5,10509890,10510167,10510028,277
258,3482216,1,465818,467065,466441,1247
259,3482216,1,19875236,19876229,19875732,993
260,3482216,2,7045036,7046890,7045963,1854
261,3482216,2,7654849,7654852,7654850,3
262,3482216,3,11745009,11745471,11745240,462
263,3482216,5,22992900,22993263,22993081,363
264,3482217,1,24418212,24418421,24418316,209
265,3482217,2,7064795,7065074,7064934,279
266,3482217,2,10149267,10149322,10149294,55
267,3482217,2,18463888,18464009,18463948,121
268,3482217,3,11221075,11221174,11221124,99
269,3482217,3,11738697,11738802,11738749,105
270,3482217,4,15913405,15913545,15913475,140
271,3482217,5,17824028,17824282,17824155,254
272,3482217,5,26676209,26676447,26676328,238
273,3482218,1,23801444,23802518,23801981,1074
274,3482218,1,25936583,25936773,25936678,190
275,3482218,3,21708461,21708486,21708473,25
276,3482218,5,1349513,1350018,1349765,505
277,3482218,5,3012978,3014614,3013796,1636
278,3482218,5,16616295,16616346,16616320,51
279,3482218,5,17383120,17383197,17383158,77
280,3482218,5,19356353,19356404,19356378,51
281,3482219,1,1203783,1204549,1204166,766
282,3482219,1,16132664,16132859,16132761,195
283,3482219,2,7292485,7292615,7292550,130
284,3482219,3,390142,390248,390195,106
285,3482219,3,6816681,6818439,6817560,1758
286,3482219,3,10728774,10730044,10729409,1270
287,3482219,4,8112418,8112891,8112654,473
288,3482219,4,9240644,9241336,9240990,692
289,3482219,5,979440,980275,979857,835
290,3482219,5,16881844,16882212,16882028,368
291,3482220,1,11758196,11759744,11758970,1548
292,3482220,1,21243143,21243290,21243216,147
293,3482220,2,11110189,11112386,11111287,2197
294,3482220,4,12513125,12514093,12513609,968
295,3482220,5,9284233,9287919,9286076,3686
296,3482221,1,23285273,23286065,23285669,792
297,3482221,1,23735875,23736353,23736114,478
298,3482221,2,6711648,6712841,6712244,1193
299,3482221,2,7718239,7718300,7718269,61
300,3482221,3,1689577,1690207,1689892,630
301,3482221,3,2156926,2157444,2157185,518
302,3482221,3,15184046,15184618,15184332,572
303,3482221,4,7255750,7255895,7255822,145
304,3482221,4,11722192,11722896,11722544,704
305,3482221,5,1008431,1009181,1008806,750
306,3482221,5,18075023,18075337,18075180,314
307,3482221,5,21317743,21317764,21317753,21
308,3482221,5,21320450,21320458,21320454,8
309,3482222,1,2569574,2569693,2569633,119
310,3482222,1,16579070,16579780,16579425,710
311,3482222,1,18176694,18176761,18176727,67
312,3482222,1,26836574,26836903,26836738,329
313,3482222,2,18900638,18900853,18900745,215
314,3482222,3,7303614,7303948,7303781,334
315,3482222,3,14938882,14939116,14938999,234
316,3482222,4,5756482,5756555,5756518,73
317,3482222,4,10009823,10010111,10009967,288
318,3482223,1,26467960,26468178,26468069,218
319,3482223,2,493083,493516,493299,433
320,3482223,2,6494074,6494161,6494117,87
321,3482223,3,3127202,3127566,3127384,364
322,3482223,4,5318062,5318235,5318148,173
323,3482223,4,17536814,17537246,17537030,432
324,3482223,5,10263064,10263147,10263105,83
325,3482223,5,18162507,18162562,18162534,55
326,3482224,1,1841889,1842417,1842153,528
327,3482224,1,10787807,10796344,10792075,8537
328,3482224,1,11318153,11318183,11318168,30
329,3482224,2,10073769,10074197,10073983,428
330,3482224,2,12173480,12173985,12173732,505
331,3482224,3,17385918,17386059,17385988,141
332,3482224,4,7216352,7221666,7219009,5314
333,3482224,4,10149915,10150852,10150383,937
334,3482224,4,17654284,17654398,17654341,114
335,3482224,5,6619211,6619435,6619323,224
336,3482225,2,1356224,1358259,1357241,2035
337,3482225,2,2095889,2096486,2096187,597
338,3482225,3,5244782,5244845,5244813,63
339,3482225,4,7174693,7174699,7174696,6
340,3482225,5,18169149,18169406,18169277,257
341,3482226,1,7748134,7748156,7748145,22
342,3482226,1,16357365,16357460,16357412,95
343,3482226,1,28966452,28968213,28967332,1761
344,3482226,2,236132,236947,236539,815
345,3482226,2,4808219,4810087,4809153,1868
346,3482226,3,8091540,8091570,8091555,30
347,3482226,4,17444121,17444262,17444191,141
348,3482226,5,13195346,13226056,13210701,30710
349,3482226,5,18991586,18991722,18991654,136
350,3482227,1,10643056,10643565,10643310,509
351,3482227,1,16772524,16774691,16773607,2167
352,3482227,1,19843764,19844927,19844345,1163
353,3482227,1,26324339,26324533,26324436,194
354,3482227,2,407596,409389,408492,1793
355,3482227,2,16367866,16369471,16368668,1605
356,3482227,3,10472364,10472449,10472406,85
357,3482227,3,22694357,22700669,22697513,6312
358,3482227,5,13602075,13603483,13602779,1408
359,3482227,5,16249096,16249130,16249113,34
360,3482228,1,10111215,10112033,10111624,818
361,3482228,1,20730599,20730847,20730723,248
362,3482228,1,27994102,27994931,27994516,829
363,3482228,3,17443341,17444072,17443706,731
364,3482228,3,20231761,20235356,20233558,3595
365,3482228,4,17359954,17361409,17360681,1455
366,3482228,5,5749451,5750033,5749742,582
367,3482228,5,21843660,21843810,21843735,150
368,3482229,1,1520254,1520831,1520542,577
369,3482229,1,10375309,10375332,10375320,23
370,3482229,1,24843650,24843808,24843729,158
371,3482229,1,28175694,28176785,28176239,1091
372,3482229,2,2087623,2089521,2088572,1898
373,3482229,2,2179403,2181177,2180290,1774
374,3482229,2,15619331,15619725,15619528,394
375,3482229,3,1441688,1442773,1442230,1085
376,3482229,3,21331670,21331899,21331784,229
377,3482229,4,4870002,4870041,4870021,39
378,3482229,4,5837148,5837412,5837280,264
379,3482229,4,7380158,7380679,7380418,521
380,3482229,5,7196068,7196969,7196518,901
381,3482229,5,18166966,18168061,18167513,1095
382,3482229,5,22557681,22557944,22557812,263
383,3482230,1,8543858,8544508,8544183,650
384,3482230,2,479089,479388,479238,299
385,3482230,3,2857360,2858901,2858130,1541
386,3482230,3,8147608,8149571,8148589,1963
387,3482230,4,4849455,4849531,4849493,76
388,3482230,4,7530864,7530910,7530887,46
389,3482230,4,12609969,12609971,12609970,2
390,3482230,5,5237964,5239256,5238610,1292
391,3482230,5,7258285,7258311,7258298,26
392,3482230,5,21062194,21062664,21062429,470
393,3482231,1,7700967,7701127,7701047,160
394,3482231,1,26091799,26092584,26092191,785
395,3482231,2,10384097,10384378,10384237,281
396,3482231,3,22958753,22958815,22958784,62
397,3482231,4,17527564,17527900,17527732,336
398,3482231,5,1014967,1016502,1015734,1535
399,3482231,5,9010804,9011642,9011223,838
400,3482232,1,1424528,1424666,1424597,138
401,3482232,1,26334476,26336429,26335452,1953
402,3482232,3,3864747,3864933,3864840,186
403,3482232,3,9493282,9493320,9493301,38
404,3482232,3,10403827,10404084,10403955,257
405,3482232,5,373911,374023,373967,112
406,3482232,5,9850838,9851813,9851325,975
407,3482233,1,1459407,1459918,1459662,511
408,3482233,1,22197760,22198105,22197932,345
409,3482233,2,16001065,16002020,16001542,955
410,3482233,3,6546841,6547659,6547250,818
411,3482233,4,1175670,1175715,1175692,45
412,3482233,5,2076564,2077693,2077128,1129
413,3482233,5,5712111,5712376,5712243,265
414,3482234,1,13043194,13043292,13043243,98
415,3482234,1,16000613,16000724,16000668,111
416,3482234,2,9582401,9582496,9582448,95
417,3482234,2,12196906,12196915,12196910,9
418,3482234,3,10144806,10144811,10144808,5
419,3482234,4,6041258,6041689,6041473,431
420,3482235,1,2216192,2217110,2216651,918
421,3482235,1,16166640,16166837,16166738,197
422,3482235,1,24508303,24508610,24508456,307
423,3482235,2,9738494,9738548,9738521,54
424,3482235,2,18539861,18539902,18539881,41
425,3482235,3,4219470,4220861,4220165,1391
426,3482235,3,7123544,7123863,7123703,319
427,3482235,4,5184692,5184731,5184711,39
428,3482235,4,6185472,6185676,6185574,204
429,3482235,5,1398369,1398509,1398439,140
430,3482236,1,21924724,21924755,21924739,31
431,3482236,1,26105304,26105465,26105384,161
432,3482236,2,6788170,6788484,6788327,314
433,3482236,3,718754,720562,719658,1808
434,3482236,3,15195712,15195814,15195763,102
435,3482236,3,16909848,16909864,16909856,16
436,3482236,4,10577862,10579834,10578848,1972
437,3482236,5,119310,119395,119352,85
438,3482236,5,1584173,1585219,1584696,1046
439,3482236,5,4525666,4525894,4525780,228
440,3482236,5,9192367,9192484,9192425,117
441,3482236,5,9887959,9888008,9887983,49
442,3482236,5,10580646,10580805,10580725,159
443,3482236,5,17571031,17571127,17571079,96
444,3482236,5,18185218,18185270,18185244,52
445,3482236,5,20807881,20808562,20808221,681
446,3482236,5,22662476,22665793,22664134,3317
447,3482236,5,23349666,23350801,23350233,1135
448,3482236,5,24249986,24250105,24250045,119
449,3482237,1,13049244,13049584,13049414,340
450,3482237,1,28629054,28629358,28629206,304
451,3482237,2,9700065,9700552,9700308,487
452,3482237,3,1655426,1657500,1656463,2074
453,3482237,3,9802078,9802973,9802525,895
454,3482237,3,10332687,10332905,10332796,218
455,3482237,4,5277621,5284838,5281229,7217
456,3482237,4,15191207,15193278,15192242,2071
457,3482237,5,7191119,7191461,7191290,342
458,3482237,5,18363902,18364817,18364359,915
459,3482237,5,22201322,22201652,22201487,330
460,3482238,1,6255156,6255739,6255447,583
461,3482238,1,11182598,11183383,11182990,785
462,3482238,1,23246190,23246976,23246583,786
463,3482238,1,24187197,24187263,24187230,66
464,3482238,2,6850135,6850622,6850378,487
465,3482238,2,13833391,13833497,13833444,106
466,3482238,3,9325930,9326967,9326448,1037
467,3482238,4,5708470,5708719,5708594,249
468,3482238,5,7759614,7759735,7759674,121
469,3482238,5,16025286,16027391,16026338,2105
470,3482238,5,24007161,24008156,24007658,995
471,3482239,1,17198312,17200316,17199314,2004
472,3482239,1,27091471,27093949,27092710,2478
473,3482239,3,20285300,20287753,20286526,2453
474,3482239,5,6607721,6610020,6608870,2299
475,3482239,5,26065044,26065058,26065051,14
476,3482240,1,1623650,1624709,1624179,1059
477,3482240,1,24100750,24102828,24101789,2078
478,3482240,2,12843163,12843185,12843174,22
479,3482240,3,20172063,20172915,20172489,852
480,3482240,3,22760657,22761233,22760945,576
481,3482240,4,9300162,9300688,9300425,526
482,3482240,5,1725961,1726029,1725995,68
483,3482240,5,10784672,10792898,10788785,8226
484,3482241,1,5393607,5397074,5395340,3467
485,3482241,2,13153792,13153796,13153794,4
486,3482241,3,18506185,18506207,18506196,22
487,3482241,4,926537,926755,926646,218
488,3482241,4,7721355,7722525,7721940,1170
489,3482241,5,16940680,16942707,16941693,2027
490,3482242,1,6880737,6881798,6881267,1061
491,3482242,1,8992204,8992478,8992341,274
492,3482242,1,23787062,23787767,23787414,705
493,3482242,2,6866735,6866804,6866769,69
494,3482242,2,11586545,11586717,11586631,172
495,3482242,3,3621931,3621971,3621951,40
496,3482242,3,16392384,16392685,16392534,301
497,3482242,5,15709947,15710140,15710043,193
498,3482242,5,25824145,25824247,25824196,102
499,3482243,1,11157244,11157570,11157407,326
500,3482243,1,17195202,17195612,17195407,410
501,3482243,2,2293837,2294167,2294002,330
502,3482243,2,11938498,11939797,11939147,1299
503,3482243,3,7227177,7227362,7227269,185
504,3482243,3,9770190,9770732,9770461,542
505,3482243,4,10461508,10461742,10461625,234
506,3482243,5,8723672,8728116,8725894,4444
507,3482243,5,9653670,9655246,9654458,1576
508,3482243,5,21062194,21062664,21062429,470
509,3482244,1,23610522,23611159,23610840,637
510,3482244,3,2705504,2705523,2705513,19
511,3482244,3,17681895,17682008,17681951,113
512,3482244,4,11867182,11868849,11868015,1667
513,3482244,5,16818016,16818130,16818073,114
514,3482245,1,10841461,10846038,10843749,4577
515,3482245,1,22487813,22487959,22487886,146
516,3482245,5,4869269,4871236,4870252,1967
517,3482246,1,611128,613796,612462,2668
518,3482246,1,17518341,17518553,17518447,212
519,3482246,1,18734176,18738544,18736360,4368
520,3482246,2,427643,427961,427802,318
521,3482246,3,17339569,17339623,17339596,54
522,3482246,4,1261658,1261675,1261666,17
523,3482246,4,11375429,11375729,11375579,300
524,3482246,5,7887779,7888157,7887968,378
525,3482246,5,17931059,17931558,17931308,499
526,3482246,5,18945536,18945789,18945662,253
527,3482247,1,8969122,8970455,8969788,1333
528,3482247,2,8256607,8256626,8256616,19
529,3482247,2,10505018,10506663,10505840,1645
530,3482247,2,18370191,18370469,18370330,278
531,3482247,3,2283080,2283106,2283093,26
532,3482247,3,11284558,11285469,11285013,911
533,3482247,4,794923,795812,795367,889
534,3482247,4,11650498,11650650,11650574,152
535,3482247,4,12519485,12520145,12519815,660
536,3482247,5,9061203,9062764,9061983,1561
537,3482247,5,9795804,9796322,9796063,518
538,3482247,5,26681557,26682032,26681794,475
539,3482248,1,267853,267910,267881,57
540,3482248,1,25352479,25353686,25353082,1207
541,3482248,2,5068885,5069851,5069368,966
542,3482248,3,606381,606497,606439,116
543,3482248,4,5242222,5242392,5242307,170
544,3482248,5,1580005,1580294,1580149,289
545,3482248,5,16198269,16198882,16198575,613
546,3482249,1,8036136,8036149,8036142,13
547,3482249,1,26422573,26423396,26422984,823
548,3482249,2,15064481,15067123,15065802,2642
549,3482249,3,1859485,1859883,1859684,398
550,3482249,3,22461445,22461738,22461591,293
551,3482249,4,8609551,8610571,8610061,1020
552,3482249,4,16909326,16910064,16909695,738
553,3482249,5,3054764,3055430,3055097,666
554,3482249,5,17750050,17750435,17750242,385
555,3482250,1,5677800,5677813,5677806,13
556,3482250,1,16460920,16460927,16460923,7
557,3482250,1,29370856,29371456,29371156,600
558,3482250,2,6741616,6741794,6741705,178
559,3482250,3,18878765,18879513,18879139,748
560,3482250,4,16992924,16994277,16993600,1353
561,3482250,5,15198240,15198513,15198376,273
562,3482251,1,11667109,11672274,11669691,5165
563,3482251,2,7309831,7309966,7309898,135
564,3482251,3,21341888,21342708,21342298,820
565,3482251,4,10608705,10608726,10608715,21
566,3482251,5,8733758,8733909,8733833,151
567,3482252,2,261747,261768,261757,21
568,3482252,2,17711382,17712239,17711810,857
569,3482252,2,18459790,18460043,18459916,253
570,3482252,3,15892111,15894889,15893500,2778
571,3482252,4,5316190,5316232,5316211,42
572,3482252,4,7637448,7637563,7637505,115
573,3482252,5,16255508,16256737,16256122,1229
574,3482252,5,17926964,17927064,17927014,100
575,3482253,1,11674919,11676640,11675779,1721
576,3482253,2,5689965,5690028,5689996,63
577,3482253,2,12905790,12907513,12906651,1723
578,3482253,2,16924722,16926170,16925446,1448
579,3482253,3,2009492,2009716,2009604,224
580,3482253,3,7701000,7701448,7701224,448
581,3482253,3,16345385,16345532,16345458,147
582,3482253,4,262466,262552,262509,86
583,3482253,4,1571145,1571474,1571309,329
584,3482253,5,26593780,26594998,26594389,1218
585,3482254,1,1429168,1429693,1429430,525
586,3482254,1,7071760,7072474,7072117,714
587,3482254,1,8604427,8604446,8604436,19
588,3482254,1,16703120,16703322,16703221,202
589,3482254,1,25617612,25618047,25617829,435
590,3482254,2,541751,542041,541896,290
591,3482254,2,14895117,14895564,14895340,447
592,3482254,3,6516216,6516618,6516417,402
593,3482254,3,21931482,21938432,21934957,6950
594,3482254,4,10193176,10194390,10193783,1214
595,3482254,5,4221235,4225576,4223405,4341
596,3482254,5,24630519,24631714,24631116,1195
597,3482255,1,7765037,7765537,7765287,500
598,3482255,1,24786856,24786952,24786904,96
599,3482255,3,745116,745800,745458,684
600,3482255,3,10720147,10720409,10720278,262
601,3482255,4,8173797,8174419,8174108,622
602,3482255,4,17602507,17603257,17602882,750
603,3482255,5,228938,230215,229576,1277
604,3482255,5,25436891,25437589,25437240,698
605,3482256,1,6228088,6228807,6228447,719
606,3482256,1,9832596,9832897,9832746,301
607,3482256,1,27837589,27838188,27837888,599
608,3482256,2,6035305,6035326,6035315,21
609,3482256,3,11720544,11720684,11720614,140
610,3482256,5,2889804,2890207,2890005,403
611,3482256,5,5462598,5462623,5462610,25
612,3482256,5,10237236,10237371,10237303,135
613,3482256,5,22529072,22530032,22529552,960
614,3482257,1,19078155,19078422,19078288,267
615,3482257,2,100349,100543,100446,194
616,3482257,5,1417382,1417648,1417515,266
617,3482258,1,11773263,11773302,11773282,39
618,3482258,1,21066079,21066889,21066484,810
619,3482258,2,9108690,9108870,9108780,180
620,3482258,4,5711769,5711811,5711790,42
621,3482258,5,15329632,15340550,15335091,10918
622,3482258,5,26384051,26384164,26384107,113
623,3482259,1,2414914,2414916,2414915,2
624,3482259,1,25680839,25682545,25681692,1706
625,3482259,1,27150107,27151141,27150624,1034
626,3482259,2,989171,989288,989229,117
627,3482259,2,6863965,6864593,6864279,628
628,3482259,2,9548770,9548963,9548866,193
629,3482259,3,19766365,19768101,19767233,1736
630,3482259,5,252914,252984,252949,70
631,3482259,5,13855693,13856471,13856082,778
632,3482260,1,1426755,1427745,1427250,990
633,3482260,1,10158485,10162386,10160435,3901
634,3482260,1,17730630,17739463,17735046,8833
635,3482260,2,5929499,5929873,5929686,374
636,3482260,2,15633334,15633817,15633575,483
637,3482260,3,4342881,4342894,4342887,13
638,3482260,4,171225,173598,172411,2373
639,3482260,4,9808446,9808526,9808486,80
640,3482260,5,834402,834849,834625,447
641,3482260,5,14076309,14076326,14076317,17
642,3482261,1,1227493,1227821,1227657,328
643,3482261,1,10167256,10167553,10167404,297
644,3482261,1,17765774,17765883,17765828,109
645,3482261,2,5939063,5939503,5939283,440
646,3482261,2,15669816,15670842,15670329,1026
647,3482261,3,4389501,4389958,4389729,457
648,3482261,4,173542,173598,173570,56
649,3482261,4,9835997,9836319,9836158,322
650,3482261,5,832598,833410,833004,812
651,3482261,5,14067592,14068970,14068281,1378
652,3482262,1,1184380,1184490,1184435,110
653,3482262,2,6684840,6684996,6684918,156
654,3482262,3,10945010,10948841,10946925,3831
655,3482262,3,17703335,17704335,17703835,1000
656,3482262,4,11735825,11736600,11736212,775
657,3482263,1,445271,446882,446076,1611
658,3482263,1,19046615,19046687,19046651,72
659,3482263,1,26179812,26179830,26179821,18
660,3482263,1,30109490,30111349,30110419,1859
661,3482263,3,7641866,7642310,7642088,444
662,3482263,3,10988402,10989456,10988929,1054
663,3482263,3,19701812,19701934,19701873,122
664,3482263,4,959029,959082,959055,53
665,3482263,4,18149448,18149815,18149631,367
666,3482263,5,3291185,3291309,3291247,124
667,3482263,5,3570088,3573854,3571971,3766
668,3482263,5,9435821,9436045,9435933,224
669,3482264,1,3218901,3219113,3219007,212
670,3482264,1,19896380,19896596,19896488,216
671,3482264,1,26763328,26767412,26765370,4084
672,3482264,3,19270241,19270484,19270362,243
673,3482264,4,6837718,6838275,6837996,557
674,3482264,4,7244857,7245228,7245042,371
675,3482264,5,2183359,2183413,2183386,54
676,3482264,5,18370340,18370408,18370374,68
677,3482264,5,24658727,24658746,24658736,19
678,3482265,1,2669013,2670892,2669952,1879
679,3482265,1,10545008,10545562,10545285,554
680,3482265,2,10358526,10358765,10358645,239
681,3482265,2,12515808,12516145,12515976,337
682,3482265,3,1453425,1453632,1453528,207
683,3482265,3,10611935,10612162,10612048,227
684,3482265,4,16540761,16540901,16540831,140
685,3482265,5,23052669,23053407,23053038,738
686,3482266,1,853568,858097,855832,4529
687,3482266,2,10812956,10813649,10813302,693
688,3482266,5,1720239,1720319,1720279,80
689,3482266,5,8655558,8655709,8655633,151
690,3482266,5,20537134,20538380,20537757,1246
691,3482267,1,17648445,17648778,17648611,333
692,3482267,2,2865594,2865633,2865613,39
693,3482267,2,4824023,4824053,4824038,30
694,3482267,2,5707249,5707360,5707304,111
695,3482267,2,12243715,12246823,12245269,3108
696,3482267,3,5079992,5080096,5080044,104
697,3482267,3,15699055,15699109,15699082,54
698,3482267,4,5758988,5759511,5759249,523
699,3482267,4,17350346,17352525,17351435,2179
700,3482267,5,1122423,1127726,1125074,5303
701,3482268,1,13997847,13998351,13998099,504
702,3482268,1,26644812,26646448,26645630,1636
703,3482268,2,19494414,19494695,19494554,281
704,3482268,3,4614851,4615397,4615124,546
705,3482268,3,16567671,16569407,16568539,1736
706,3482268,5,2264604,2266588,2265596,1984
707,3482268,5,23748786,23748886,23748836,100
708,3482269,1,11104630,11104960,11104795,330
709,3482269,1,17378332,17380083,17379207,1751
710,3482269,1,27983022,27983426,27983224,404
711,3482269,2,10910743,10910901,10910822,158
712,3482269,2,13329043,13329336,13329189,293
713,3482269,3,1227617,1228046,1227831,429
714,3482269,4,5315940,5316057,5315998,117
715,3482269,5,21320260,21320277,21320268,17
716,3482270,1,13076506,13076724,13076615,218
717,3482270,1,26679121,26680530,26679825,1409
718,3482270,2,342602,343706,343154,1104
719,3482270,5,4005108,4005302,4005205,194
720,3482270,5,16907146,16907606,16907376,460
721,3482270,5,25886315,25888445,25887380,2130
722,3482271,1,664141,665723,664932,1582
723,3482271,1,13254932,13255192,13255062,260
724,3482271,1,20043494,20045435,20044464,1941
725,3482271,2,11793023,11793444,11793233,421
726,3482271,2,12160196,12160440,12160318,244
727,3482271,3,3313287,3313590,3313438,303
728,3482271,4,10098852,10100651,10099751,1799
729,3482272,1,15994946,15995268,15995107,322
730,3482272,2,8299158,8299218,8299188,60
731,3482272,3,10047717,10048483,10048100,766
732,3482272,3,18830000,18830314,18830157,314
733,3482272,4,82526,82555,82540,29
734,3482272,4,4849531,4850138,4849834,607
735,3482272,4,17616667,17617568,17617117,901
736,3482272,5,19564643,19566135,19565389,1492
737,3482273,1,8292266,8292796,8292531,530
738,3482273,1,16736408,16736646,16736527,238
739,3482273,2,448998,449243,449120,245
740,3482273,2,2897929,2898790,2898359,861
741,3482273,2,16604549,16605114,16604831,565
742,3482273,3,10896358,10896935,10896646,577
743,3482273,3,18024676,18026812,18025744,2136
744,3482273,4,6547316,6548310,6547813,994
745,3482274,1,757164,760741,758952,3577
746,3482274,1,6642322,6642400,6642361,78
747,3482274,1,24323400,24324985,24324192,1585
748,3482274,1,29651041,29651582,29651311,541
749,3482274,2,5418394,5418733,5418563,339
750,3482274,3,2024523,2024979,2024751,456
751,3482274,3,4889340,4889345,4889342,5
752,3482274,4,5640742,5641241,5640991,499
753,3482274,4,17426592,17426637,17426614,45
754,3482274,5,4006465,4006628,4006546,163
755,3482274,5,17240511,17241534,17241022,1023
756,3482274,5,22069534,22070258,22069896,724
757,3482275,1,5751488,5751725,5751606,237
758,3482275,1,7744367,7744380,7744373,13
759,3482275,1,28905276,28905429,28905352,153
760,3482275,2,750669,751479,751074,810
761,3482275,2,12889805,12890602,12890203,797
762,3482275,3,18999958,19002787,19001372,2829
763,3482275,4,5314654,5315882,5315268,1228
764,3482275,5,939862,940266,940064,404
765,3482275,5,21274748,21275047,21274897,299
766,3482276,1,9322541,9324993,9323767,2452
767,3482276,1,24487900,24488290,24488095,390
768,3482276,2,107423,107506,107464,83
769,3482276,2,637771,639160,638465,1389
770,3482276,2,7715157,7715527,7715342,370
771,3482276,3,4545124,4545699,4545411,575
772,3482276,3,15800482,15800502,15800492,20
773,3482276,4,624351,624508,624429,157
774,3482276,4,7571789,7573424,7572606,1635
775,3482276,4,12534597,12534962,12534779,365
776,3482276,5,18367239,18369751,18368495,2512
777,3482279,1,9322541,9324993,9323767,2452
778,3482279,1,24487900,24488290,24488095,390
779,3482279,2,107423,107506,107464,83
780,3482279,2,637771,639160,638465,1389
781,3482279,2,7715157,7715527,7715342,370
782,3482279,3,4545124,4545699,4545411,575
783,3482279,3,15800482,15800502,15800492,20
784,3482279,4,624351,624508,624429,157
785,3482279,4,7571789,7573424,7572606,1635
786,3482279,4,12534597,12534962,12534779,365
787,3482279,5,18367239,18369751,18368495,2512
788,3482280,1,2669013,2670892,2669952,1879
789,3482280,1,11026450,11026841,11026645,391
790,3482280,1,11448357,11448801,11448579,444
791,3482280,2,1035525,1035738,1035631,213
792,3482280,2,2264323,2264435,2264379,112
793,3482280,3,8665756,8666272,8666014,516
794,3482280,4,12346498,12346611,12346554,113
795,3482280,5,593432,593634,593533,202
796,3482280,5,8352649,8352689,8352669,40
797,3482280,5,26495281,26495301,26495291,20
798,3482281,1,11724803,11726121,11725462,1318
799,3482281,1,23104906,23105288,23105097,382
800,3482281,2,7729721,7732739,7731230,3018
801,3482281,3,18704749,18705243,18704996,494
802,3482281,4,576276,576923,576599,647
803,3482281,4,7454102,7454238,7454170,136
804,3482281,5,6498208,6499823,6499015,1615
805,3482281,5,18365065,18365502,18365283,437
806,3482282,1,16664914,16668206,16666560,3292
807,3482282,1,19356939,19360217,19358578,3278
808,3482282,2,100082,100349,100215,267
809,3482282,2,7811153,7811358,7811255,205
810,3482282,2,16240928,16241065,16240996,137
811,3482282,3,2369784,2370435,2370109,651
812,3482282,3,2421306,2421321,2421313,15
813,3482282,3,6183381,6183512,6183446,131
814,3482282,4,16841632,16841698,16841665,66
815,3482282,5,1140210,1140412,1140311,202
816,3482283,1,3780435,3786308,3783371,5873
817,3482283,1,16775611,16775649,16775630,38
818,3482283,2,6275604,6276427,6276015,823
819,3482283,3,2856810,2857360,2857085,550
820,3482283,4,8837253,8839392,8838322,2139
821,3482283,4,14165760,14167553,14166656,1793
822,3482283,5,9935039,9935501,9935270,462
823,3482283,5,17930045,17930527,17930286,482
824,3482284,1,1882603,1882609,1882606,6
825,3482284,1,11495945,11495978,11495961,33
826,3482284,1,27002557,27002775,27002666,218
827,3482284,2,86609,86742,86675,133
828,3482284,2,1539464,1540452,1539958,988
829,3482284,2,6406696,6406978,6406837,282
830,3482284,2,16695855,16696217,16696036,362
831,3482284,3,7201120,7203394,7202257,2274
832,3482284,4,7150887,7151552,7151219,665
833,3482284,5,4732680,4732886,4732783,206
834,3482284,5,6441211,6441359,6441285,148
835,3482285,1,11117527,11117564,11117545,37
836,3482285,1,17268896,17269252,17269074,356
837,3482285,1,22167903,22168921,22168412,1018
838,3482285,2,6245247,6245275,6245261,28
839,3482285,2,9738223,9738351,9738287,128
840,3482285,3,20114371,20114895,20114633,524
841,3482285,3,21799094,21801195,21800144,2101
842,3482285,4,5242101,5242222,5242161,121
843,3482285,4,16322074,16322117,16322095,43
844,3482285,5,2643697,2645892,2644794,2195
845,3482285,5,14526374,14526623,14526498,249
846,3482286,1,13079637,13079700,13079668,63
847,3482286,3,4986402,4986651,4986526,249
848,3482286,3,9531008,9531894,9531451,886
849,3482286,4,5640574,5641241,5640907,667
850,3482286,5,5755683,5757816,5756749,2133
851,3482287,1,24059847,24062518,24061182,2671
852,3482287,2,1111003,1111050,1111026,47
853,3482287,2,18649090,18656755,18652922,7665
854,3482287,4,4867727,4867844,4867785,117
855,3482288,2,9997125,9997684,9997404,559
856,3482288,3,209646,209710,209678,64
857,3482288,3,5311412,5311551,5311481,139
858,3482288,4,14845660,14847219,14846439,1559
859,3482288,5,5406296,5406334,5406315,38
860,3482288,5,8769067,8769390,8769228,323
861,3482289,1,8631678,8631980,8631829,302
862,3482289,3,1309982,1310569,1310275,587
863,3482289,3,16616595,16617419,16617007,824
864,3482289,3,19749859,19750681,19750270,822
865,3482289,4,8045253,8045610,8045431,357
866,3482289,5,6414528,6414839,6414683,311
867,3482290,1,1557526,1559682,1558604,2156
868,3482290,1,20433320,20437144,20435232,3824
869,3482290,2,6787865,6788063,6787964,198
870,3482290,2,6788566,6788673,6788619,107
871,3482290,2,18270831,18271019,18270925,188
872,3482290,4,123751,123901,123826,150
873,3482290,4,8507135,8509004,8508069,1869
874,3482290,4,16322164,16322184,16322174,20
875,3482290,5,6216160,6217904,6217032,1744
876,3482291,1,4119698,4119877,4119787,179
877,3482291,1,6827931,6828192,6828061,261
878,3482291,1,19285119,19286355,19285737,1236
879,3482291,1,23446477,23446615,23446546,138
880,3482291,2,8181412,8181470,8181441,58
881,3482291,3,637974,638483,638228,509
882,3482291,3,16283175,16283209,16283192,34
883,3482291,4,7521491,7521926,7521708,435
884,3482292,1,19689774,19690323,19690048,549
885,3482292,1,29251638,29251902,29251770,264
886,3482292,3,4654070,4654313,4654191,243
887,3482292,4,7247349,7247605,7247477,256
888,3482292,5,15970886,15972234,15971560,1348
889,3482292,5,21628457,21628713,21628585,256
890,3482292,5,25794984,25795583,25795283,599
891,3482293,1,17617564,17618114,17617839,550
892,3482293,1,25493108,25493433,25493270,325
893,3482293,2,6685652,6686374,6686013,722
894,3482293,2,13589247,13591241,13590244,1994
895,3482293,4,676859,676946,676902,87
896,3482293,5,1258598,1258716,1258657,118
897,3482293,5,9942411,9942465,9942438,54
898,3482293,5,14775077,14775152,14775114,75
899,3482294,1,5818410,5820915,5819662,2505
900,3482294,1,30413034,30413136,30413085,102
901,3482294,2,813941,814382,814161,441
902,3482294,2,12775373,12775381,12775377,8
903,3482294,3,4558322,4558614,4558468,292
904,3482294,3,19413592,19414260,19413926,668
905,3482294,3,22901031,22901378,22901204,347
906,3482294,4,7668366,7668378,7668372,12
907,3482294,4,8767228,8767506,8767367,278
908,3482294,4,17575633,17575850,17575741,217
909,3482294,5,691721,692037,691879,316
910,3482294,5,13898359,13899748,13899053,1389
911,3482294,5,14912193,14912488,14912340,295
912,3482294,5,20754457,20754966,20754711,509
913,3482295,1,10965560,10965582,10965571,22
914,3482295,1,30412189,30412816,30412502,627
915,3482295,2,418467,419004,418735,537
916,3482295,2,16970206,16970698,16970452,492
917,3482295,3,20014149,20014398,20014273,249
918,3482295,4,5821717,5821746,5821731,29
919,3482295,5,980274,980275,980274,1
920,3482295,5,7921116,7921173,7921144,57
921,3482296,1,20561483,20563211,20562347,1728
922,3482296,1,22987195,22987479,22987337,284
923,3482296,2,1128097,1128956,1128526,859
924,3482296,2,13370598,13371687,13371142,1089
925,3482296,3,14990619,14990898,14990758,279
926,3482296,4,8897138,8897382,8897260,244
927,3482296,4,10255553,10256021,10255787,468
928,3482296,5,13683332,13683849,13683590,517
929,3482297,1,6317831,6318268,6318049,437
930,3482297,1,19468876,19468967,19468921,91
931,3482297,2,16295757,16296326,16296041,569
932,3482297,3,895006,895133,895069,127
933,3482297,4,6526666,6527834,6527250,1168
934,3482297,4,10657124,10657865,10657494,741
935,3482297,5,1949332,1950400,1949866,1068
936,3482297,5,20247470,20247488,20247479,18
937,3482298,1,17387018,17387061,17387039,43
938,3482298,1,23246791,23246976,23246883,185
939,3482298,3,9934770,9935635,9935202,865
940,3482298,4,8431000,8431174,8431087,174
941,3482298,5,7235833,7237600,7236716,1767
942,3482298,5,23060164,23060858,23060511,694
943,3482299,1,108729,109804,109266,1075
944,3482299,1,25268686,25268824,25268755,138
945,3482299,2,17075824,17076450,17076137,626
946,3482299,3,4895016,4895793,4895404,777
947,3482299,3,11752096,11752266,11752181,170
948,3482299,3,19469908,19470754,19470331,846
949,3482299,4,849062,849751,849406,689
950,3482299,4,6733870,6734671,6734270,801
951,3482299,4,17678216,17678852,17678534,636
952,3482299,5,26028137,26028311,26028224,174
953,3482300,1,2624102,2624195,2624148,93
954,3482300,1,22629792,22629793,22629792,1
955,3482300,2,852811,852850,852830,39
956,3482300,3,9307881,9308296,9308088,415
957,3482300,4,16807855,16809937,16808896,2082
958,3482300,5,20748280,20748374,20748327,94
959,3482300,5,25215027,25215065,25215046,38
960,3482301,1,1885653,1886093,1885873,440
961,3482301,1,11465639,11465795,11465717,156
962,3482301,1,27132746,27132991,27132868,245
963,3482301,1,29938903,29938918,29938910,15
964,3482301,3,9283871,9284377,9284124,506
965,3482301,4,6580909,6581366,6581137,457
966,3482301,4,14864217,14864972,14864594,755
967,3482301,5,5842536,5843302,5842919,766
968,3482301,5,17470489,17470604,17470546,115
969,3482301,5,21422848,21423165,21423006,317
970,3482302,1,17298209,17298520,17298364,311
971,3482302,1,24885785,24885824,24885804,39
972,3482302,2,133691,134176,133933,485
973,3482302,2,5800537,5800585,5800561,48
974,3482302,2,8367977,8368815,8368396,838
975,3482302,3,15906538,15906941,15906739,403
976,3482302,3,19869365,19869913,19869639,548
977,3482303,1,662030,662688,662359,658
978,3482303,1,7522348,7522615,7522481,267
979,3482303,1,8012172,8012374,8012273,202
980,3482303,2,7925707,7925721,7925714,14
981,3482303,3,18751617,18752743,18752180,1126
982,3482303,4,176314,176748,176531,434
983,3482303,4,10270556,10271931,10271243,1375
984,3482303,5,18637845,18638333,18638089,488
985,3482303,5,25538253,25538367,25538310,114
986,3482304,1,2843380,2843607,2843493,227
987,3482304,1,13144118,13144201,13144159,83
988,3482304,1,22930168,22931256,22930712,1088
989,3482304,2,7308767,7309831,7309299,1064
990,3482304,2,16452451,16452769,16452610,318
991,3482304,3,7623520,7625134,7624327,1614
992,3482304,3,8233147,8233255,8233201,108
993,3482304,4,14579486,14579640,14579563,154
994,3482304,5,18817297,18817466,18817381,169
995,3482304,5,24803762,24804106,24803934,344
996,3482305,1,9724130,9724172,9724151,42
997,3482305,1,29951108,29953078,29952093,1970
998,3482305,2,147045,147111,147078,66
999,3482305,3,6107332,6109904,6108618,2572
1000,3482305,3,7775023,7776662,7775842,1639
1001,3482305,3,17132927,17133028,17132977,101
1002,3482305,4,9061772,9061885,9061828,113
1003,3482305,5,7662889,7662955,7662922,66
1004,3482306,1,7322312,7322725,7322518,413
1005,3482306,1,24557294,24557842,24557568,548
1006,3482306,2,16839813,16839840,16839826,27
1007,3482306,3,9049487,9049817,9049652,330
1008,3482306,3,11182432,11182535,11182483,103
1009,3482306,4,5724993,5725024,5725008,31
1010,3482306,5,26770982,26771186,26771084,204
1011,3482307,1,1219320,1219574,1219447,254
1012,3482307,1,11589257,11592201,11590729,2944
1013,3482307,3,4888237,4888289,4888263,52
1014,3482307,3,15656384,15656893,15656638,509
1015,3482307,4,5359320,5359418,5359369,98
1016,3482307,4,8062157,8062575,8062366,418
1017,3482307,5,15784613,15787980,15786296,3367
1018,3482307,5,17793687,17794120,17793903,433
1019,3482307,5,25881522,25882098,25881810,576
1020,3482308,1,26141103,26141163,26141133,60
1021,3482308,1,28104705,28104741,28104723,36
1022,3482308,3,10139463,10139520,10139491,57
1023,3482308,5,19598780,19599799,19599289,1019
1024,3482308,5,20691200,20693981,20692590,2781
1025,3482309,1,12955148,12955570,12955359,422
1026,3482309,1,26538599,26539239,26538919,640
1027,3482309,2,10094384,10095100,10094742,716
1028,3482309,2,15016173,15016649,15016411,476
1029,3482309,3,10172343,10172371,10172357,28
1030,3482309,3,15864725,15865029,15864877,304
1031,3482309,4,10161036,10161110,10161073,74
1032,3482309,5,19975348,19976166,19975757,818
1033,3482310,1,17530389,17530476,17530432,87
1034,3482310,2,2924135,2924570,2924352,435
1035,3482310,2,15375074,15375576,15375325,502
1036,3482310,3,5760645,5761417,5761031,772
1037,3482310,3,9212272,9213039,9212655,767
1038,3482310,3,15784011,15784188,15784099,177
1039,3482310,4,6049747,6050502,6050124,755
1040,3482310,4,18388414,18388648,18388531,234
1041,3482310,5,8359840,8360127,8359983,287
1042,3482310,5,26812048,26812477,26812262,429
1043,3482311,1,254048,254155,254101,107
1044,3482311,1,10266385,10266830,10266607,445
1045,3482311,1,20534398,20535051,20534724,653
1046,3482311,1,23142761,23143724,23143242,963
1047,3482311,2,9221450,9222922,9222186,1472
1048,3482311,3,73890,74162,74026,272
1049,3482311,3,6390143,6391084,6390613,941
1050,3482311,3,16930079,16930421,16930250,342
1051,3482311,3,19840611,19841573,19841092,962
1052,3482311,4,364286,364763,364524,477
1053,3482311,4,12313673,12313674,12313673,1
1054,3482311,5,978449,978512,978480,63
1055,3482311,5,21442399,21443809,21443104,1410
1056,3482312,1,275291,275504,275397,213
1057,3482312,1,3439545,3440720,3440132,1175
1058,3482312,1,6756167,6756624,6756395,457
1059,3482312,1,16443663,16443813,16443738,150
1060,3482312,1,19687846,19687885,19687865,39
1061,3482312,2,8581436,8582411,8581923,975
1062,3482312,3,11773216,11773337,11773276,121
1063,3482312,3,22202177,22202302,22202239,125
1064,3482312,4,9959014,9959105,9959059,91
1065,3482312,4,15595835,15597865,15596850,2030
1066,3482312,5,7867732,7867989,7867860,257
1067,3482313,1,730948,732827,731887,1879
1068,3482313,1,5522421,5523865,5523143,1444
1069,3482313,2,2270693,2270822,2270757,129
1070,3482313,2,19219928,19221924,19220926,1996
1071,3482313,3,17685612,17686476,17686044,864
1072,3482313,4,16168021,16168472,16168246,451
1073,3482313,5,2884562,2885142,2884852,580
1074,3482313,5,18929687,18931512,18930599,1825
1075,3482314,1,10058711,10058862,10058786,151
1076,3482314,1,19685182,19685636,19685409,454
1077,3482314,2,6226586,6227500,6227043,914
1078,3482314,3,7462694,7462738,7462716,44
1079,3482314,3,10352076,10353044,10352560,968
1080,3482314,4,775205,776882,776043,1677
1081,3482314,4,17995857,17998829,17997343,2972
1082,3482314,5,9318487,9320623,9319555,2136
1083,3482315,1,11443642,11443821,11443731,179
1084,3482315,1,11829598,11830449,11830023,851
1085,3482315,2,9990149,9990901,9990525,752
1086,3482315,3,634654,636199,635426,1545
1087,3482315,5,318524,320397,319460,1873
1088,3482315,5,13880845,13880957,13880901,112
1089,3482315,5,16436732,16437900,16437316,1168
1090,3482316,1,13312330,13312861,13312595,531
1091,3482316,2,16650174,16650498,16650336,324
1092,3482316,3,8920698,8921159,8920928,461
1093,3482316,4,7634164,7634209,7634186,45
1094,3482316,5,21309953,21311199,21310576,1246
1095,3482317,1,16772516,16772524,16772520,8
1096,3482317,1,27536630,27536983,27536806,353
1097,3482317,2,2270200,2270690,2270445,490
1098,3482317,3,18510482,18510738,18510610,256
1099,3482317,4,5426726,5426998,5426862,272
1100,3482317,4,9370794,9370879,9370836,85
1101,3482317,5,18164254,18164348,18164301,94
1102,3482318,1,4277492,4277687,4277589,195
1103,3482318,1,13405076,13405260,13405168,184
1104,3482318,2,278489,278543,278516,54
1105,3482318,2,2230203,2230482,2230342,279
1106,3482318,2,14887516,14889164,14888340,1648
1107,3482318,3,8688688,8690574,8689631,1886
1108,3482318,4,10379,11538,10958,1159
1109,3482318,4,10268664,10268960,10268812,296
1110,3482318,5,3085750,3085934,3085842,184
1111,3482318,5,18959937,18959987,18959962,50
1112,3482319,1,9043388,9043847,9043617,459
1113,3482319,1,13039224,13043194,13041209,3970
1114,3482319,2,9541590,9543440,9542515,1850
1115,3482319,2,18344001,18344068,18344034,67
1116,3482319,4,11880585,11881236,11880910,651
1117,3482319,5,1582736,1583855,1583295,1119
1118,3482320,1,21882107,21882129,21882118,22
1119,3482320,2,8048864,8049553,8049208,689
1120,3482320,2,18620811,18623776,18622293,2965
1121,3482320,3,1134859,1134999,1134929,140
1122,3482320,3,10628487,10628522,10628504,35
1123,3482320,4,687552,687873,687712,321
1124,3482320,4,1143712,1144368,1144040,656
1125,3482320,5,14737141,14738121,14737631,980
1126,3482321,2,414207,415053,414630,846
1127,3482321,3,9771562,9771988,9771775,426
1128,3482321,3,18752897,18753349,18753123,452
1129,3482321,4,5315940,5316057,5315998,117
1130,3482321,5,777730,778009,777869,279
1131,3482321,5,4605074,4605434,4605254,360
1132,3482321,5,15814262,15814948,15814605,686
1133,3482322,1,25616198,25617612,25616905,1414
1134,3482322,2,6418825,6418879,6418852,54
1135,3482322,2,13111890,13115666,13113778,3776
1136,3482322,4,17872548,17872637,17872592,89
1137,3482323,1,4064374,4065249,4064811,875
1138,3482323,1,29155842,29156281,29156061,439
1139,3482323,2,16455228,16455590,16455409,362
1140,3482323,3,6745394,6745988,6745691,594
1141,3482323,3,9372342,9372485,9372413,143
1142,3482323,4,7371760,7372359,7372059,599
1143,3482323,4,17779911,17779930,17779920,19
1144,3482323,5,24166242,24166362,24166302,120
1145,3482326,1,13450223,13451741,13450982,1518
1146,3482326,1,23510793,23511123,23510958,330
1147,3482326,2,116877,118006,117441,1129
1148,3482326,4,6796827,6797695,6797261,868
1149,3482326,4,7463965,7465037,7464501,1072
1150,3482326,5,4765724,4766374,4766049,650
1151,3482326,5,16739235,16740345,16739790,1110
1152,3482327,2,7209150,7210513,7209831,1363
1153,3482327,2,9015121,9015226,9015173,105
1154,3482327,2,18998998,18999522,18999260,524
1155,3482327,3,653012,653456,653234,444
1156,3482327,3,11047107,11047119,11047113,12
1157,3482327,4,782877,782911,782894,34
1158,3482327,4,14645810,14646381,14646095,571
1159,3482327,5,17821205,17821701,17821453,496
1160,3482327,5,25717116,25717742,25717429,626
1161,3482328,1,4061906,4061913,4061909,7
1162,3482328,2,598794,599264,599029,470
1163,3482328,4,17036230,17036817,17036523,587
1164,3482328,5,19148682,19149835,19149258,1153
1165,3482328,5,21108504,21109230,21108867,726
1166,3482329,1,7843632,7845062,7844347,1430
1167,3482329,1,10050177,10050284,10050230,107
1168,3482329,1,21340087,21340526,21340306,439
1169,3482329,1,22069960,22070099,22070029,139
1170,3482329,2,9984684,9984822,9984753,138
1171,3482329,3,2048731,2048792,2048761,61
1172,3482329,3,9933959,9934742,9934350,783
1173,3482329,3,21057232,21059262,21058247,2030
1174,3482329,5,1090519,1091422,1090970,903
1175,3482329,5,8638039,8638164,8638101,125
1176,3482329,5,23931076,23931293,23931184,217
1177,3482330,1,12422140,12422193,12422166,53
1178,3482330,2,14687755,14687815,14687785,60
1179,3482330,3,19647574,19648925,19648249,1351
1180,3482330,4,9030585,9030726,9030655,141
1181,3482330,5,21465361,21465623,21465492,262
1182,3482331,1,25275454,25276330,25275892,876
1183,3482331,1,28456198,28458552,28457375,2354
1184,3482331,2,8420182,8423785,8421983,3603
1185,3482331,2,12226543,12226896,12226719,353
1186,3482331,2,19228002,19230333,19229167,2331
1187,3482331,3,4770192,4770616,4770404,424
1188,3482331,3,10995340,10995448,10995394,108
1189,3482331,4,11255974,11256050,11256012,76
1190,3482331,5,767682,768124,767903,442
1191,3482331,5,9357531,9357634,9357582,103
1192,3482331,5,16844126,16844937,16844531,811
1193,3482331,5,25094569,25095319,25094944,750
1194,3482332,1,4150574,4151616,4151095,1042
1195,3482332,1,29839541,29841831,29840686,2290
1196,3482332,2,11271929,11271986,11271957,57
1197,3482332,4,5150095,5150380,5150237,285
1198,3482334,1,4103558,4105057,4104307,1499
1199,3482334,1,25702723,25702991,25702857,268
1200,3482334,2,2929980,2930250,2930115,270
1201,3482334,4,11445880,11446071,11445975,191
1202,3482334,4,17668734,17669326,17669030,592
1203,3482334,5,10266273,10266860,10266566,587
1204,3482334,5,26298865,26299534,26299199,669
1205,3482335,1,4983061,4985406,4984233,2345
1206,3482335,1,20353008,20353186,20353097,178
1207,3482335,2,412899,414207,413553,1308
1208,3482335,3,1839488,1839852,1839670,364
1209,3482335,3,19973768,19974301,19974034,533
1210,3482335,4,487881,487887,487884,6
1211,3482335,5,6579115,6580627,6579871,1512
1212,3482335,5,18485721,18485829,18485775,108
1213,3482336,1,20009617,20009678,20009647,61
1214,3482336,2,7859782,7859890,7859836,108
1215,3482336,2,7901493,7902033,7901763,540
1216,3482336,3,8772923,8773610,8773266,687
1217,3482337,1,16550979,16560712,16555845,9733
1218,3482337,1,23967396,23967537,23967466,141
1219,3482337,3,9951956,9952560,9952258,604
1220,3482337,5,13560485,13562959,13561722,2474
1221,3482338,1,2625164,2625206,2625185,42
1222,3482338,1,3429840,3435255,3432547,5415
1223,3482338,1,8571907,8572056,8571981,149
1224,3482338,1,29407475,29407512,29407493,37
1225,3482338,2,6916641,6916796,6916718,155
1226,3482338,2,9660944,9662293,9661618,1349
1227,3482338,3,9902623,9902913,9902768,290
1228,3482338,4,925690,926452,926071,762
1229,3482338,4,8015865,8015900,8015882,35
1230,3482338,5,324024,324050,324037,26
1231,3482338,5,5650259,5650590,5650424,331
1232,3482338,5,10472138,10472875,10472506,737
1233,3482338,5,21131808,21134197,21133002,2389
1234,3482339,1,29474165,29474237,29474201,72
1235,3482339,2,2281794,2282406,2282100,612
1236,3482339,3,17549767,17550449,17550108,682
1237,3482339,4,12770274,12771205,12770739,931
1238,3482339,5,17057017,17057022,17057019,5
1239,3482339,5,21438358,21438433,21438395,75
1240,3482340,2,483330,484028,483679,698
1241,3482340,2,15168493,15169425,15168959,932
1242,3482340,3,8077198,8077787,8077492,589
1243,3482340,3,18707914,18708149,18708031,235
1244,3482340,4,10006303,10006334,10006318,31
1245,3482340,5,2189921,2190490,2190205,569
1246,3482340,5,14227516,14229968,14228742,2452
1247,3482340,5,14990635,14990707,14990671,72
1248,3482341,1,26155556,26155964,26155760,408
1249,3482341,1,27137072,27137169,27137120,97
1250,3482341,2,1493666,1493681,1493673,15
1251,3482341,2,2100507,2100673,2100590,166
1252,3482341,2,9840140,9841163,9840651,1023
1253,3482341,3,18360125,18360168,18360146,43
1254,3482341,5,10380038,10380827,10380432,789
1255,3482341,5,22560689,22560770,22560729,81
1256,3482342,1,1381391,1382716,1382053,1325
1257,3482342,1,17181284,17181584,17181434,300
1258,3482342,1,22766172,22768227,22767199,2055
1259,3482342,2,6354951,6355566,6355258,615
1260,3482342,2,16495483,16495679,16495581,196
1261,3482342,4,7229323,7229341,7229332,18
1262,3482342,5,8879534,8882198,8880866,2664
1263,3482342,5,17061991,17062161,17062076,170
1264,3482343,1,13894626,13894679,13894652,53
1265,3482343,1,25322720,25322931,25322825,211
1266,3482343,2,2270693,2270822,2270757,129
1267,3482343,3,1440308,1440427,1440367,119
1268,3482343,3,3939031,3941568,3940299,2537
1269,3482343,3,8997088,8997613,8997350,525
1270,3482343,4,188702,189437,189069,735
1271,3482343,4,855491,857355,856423,1864
1272,3482343,5,26239598,26241405,26240501,1807
1273,3482344,1,10585915,10585963,10585939,48
1274,3482344,1,28528680,28529015,28528847,335
1275,3482344,2,1493525,1493666,1493595,141
1276,3482344,3,19792389,19792510,19792449,121
1277,3482344,5,1609355,1610302,1609828,947
1278,3482344,5,21251529,21252221,21251875,692
1279,3482345,1,17082089,17083051,17082570,962
1280,3482345,2,11561515,11563607,11562561,2092
1281,3482345,4,5430207,5430272,5430239,65
1282,3482345,4,6216401,6217089,6216745,688
1283,3482345,5,2996841,2997794,2997317,953
1284,3482345,5,25398385,25399143,25398764,758
1285,3482346,1,3496638,3499224,3497931,2586
1286,3482346,1,29308850,29309432,29309141,582
1287,3482346,2,8278441,8281565,8280003,3124
1288,3482346,3,9261410,9261860,9261635,450
1289,3482346,4,6135538,6136374,6135956,836
1290,3482346,5,692166,692196,692181,30
1291,3482346,5,17553589,17553781,17553685,192
1292,3482347,1,4168549,4169521,4169035,972
1293,3482347,1,7550345,7550537,7550441,192
1294,3482347,1,30146528,30147143,30146835,615
1295,3482347,2,6865507,6865840,6865673,333
1296,3482347,3,5761417,5761598,5761507,181
1297,3482347,3,18231880,18232581,18232230,701
1298,3482347,4,18082922,18083212,18083067,290
1299,3482347,5,2834112,2838442,2836277,4330
1300,3482347,5,13195275,13195346,13195310,71
1301,3482347,5,16669939,16670319,16670129,380
1302,3482348,1,11378948,11379034,11378991,86
1303,3482348,1,23073236,23074795,23074015,1559
1304,3482348,2,6308447,6309098,6308772,651
1305,3482348,2,7930124,7930205,7930164,81
1306,3482348,3,8961924,8962479,8962201,555
1307,3482348,4,17398846,17401918,17400382,3072
1308,3482348,5,9542206,9542418,9542312,212
1309,3482348,5,16833417,16834584,16834000,1167
1310,3482348,5,18219893,18220022,18219957,129
1311,3482349,1,753227,753480,753353,253
1312,3482349,1,2166974,2167504,2167239,530
1313,3482349,1,12528613,12529263,12528938,650
1314,3482349,1,13117350,13117380,13117365,30
1315,3482349,3,15539208,15539876,15539542,668
1316,3482349,3,17535934,17536040,17535987,106
1317,3482349,5,26133922,26133929,26133925,7
1318,3482350,1,11821235,11822267,11821751,1032
1319,3482350,2,19468251,19468508,19468379,257
1320,3482350,3,895006,895133,895069,127
1321,3482350,3,5653193,5653979,5653586,786
1322,3482350,3,14947733,14950258,14948995,2525
1323,3482350,4,12507849,12508763,12508306,914
1324,3482350,4,16549120,16549691,16549405,571
1325,3482351,1,11118757,11119152,11118954,395
1326,3482351,1,11834444,11836873,11835658,2429
1327,3482351,1,25232429,25233302,25232865,873
1328,3482351,2,1381410,1381509,1381459,99
1329,3482351,3,1844312,1844755,1844533,443
1330,3482351,5,10473223,10473455,10473339,232
1331,3482352,1,10853483,10853554,10853518,71
1332,3482352,1,24368843,24369016,24368929,173
1333,3482352,1,25457906,25459127,25458516,1221
1334,3482352,3,7838284,7839717,7839000,1433
1335,3482352,3,10952976,10953054,10953015,78
1336,3482352,3,18130016,18130447,18130231,431
1337,3482352,4,5370443,5370652,5370547,209
1338,3482352,5,803849,805784,804816,1935
1339,3482352,5,17587238,17587641,17587439,403
1340,3482352,5,19942264,19943379,19942821,1115
1341,3482353,1,8150286,8150545,8150415,259
1342,3482353,1,8292266,8292796,8292531,530
1343,3482353,1,22009560,22010484,22010022,924
1344,3482353,2,5951310,5955460,5953385,4150
1345,3482353,3,3184436,3185264,3184850,828
1346,3482353,5,14992103,14992496,14992299,393
1347,3482353,5,17198212,17198667,17198439,455
1348,3482353,5,22809800,22811115,22810457,1315
1349,3482354,1,3751111,3753730,3752420,2619
1350,3482354,1,18001446,18007838,18004642,6392
1351,3482354,1,23042685,23044441,23043563,1756
1352,3482354,2,11725211,11726041,11725626,830
1353,3482354,2,18617013,18617247,18617130,234
1354,3482354,3,4778113,4778277,4778195,164
1355,3482354,3,8123059,8123099,8123079,40
1356,3482354,3,20433725,20433779,20433752,54
1357,3482354,4,9461688,9462047,9461867,359
1358,3482354,4,16665688,16665896,16665792,208
1359,3482354,5,9852803,9853464,9853133,661
1360,3482354,5,14884924,14888177,14886550,3253
1361,3482354,5,19980854,19980873,19980863,19
1362,3482355,1,11914409,11921283,11917846,6874
1363,3482355,2,9670002,9670436,9670219,434
1364,3482355,3,2661312,2662383,2661847,1071
1365,3482355,3,18151833,18154240,18153036,2407
1366,3482355,4,7935886,7936915,7936400,1029
1367,3482355,5,578516,578868,578692,352
1368,3482355,5,8774995,8775524,8775259,529
1369,3482355,5,25432476,25432802,25432639,326
1370,3482356,1,23021953,23022060,23022006,107
1371,3482356,3,4905901,4906991,4906446,1090
1372,3482356,3,7645746,7646616,7646181,870
1373,3482356,5,767682,768124,767903,442
1374,3482356,5,8562932,8563026,8562979,94
1375,3482357,1,267352,267588,267470,236
1376,3482357,1,17270860,17271012,17270936,152
1377,3482357,2,10895938,10896807,10896372,869
1378,3482357,3,8118162,8118276,8118219,114
1379,3482357,4,17667067,17667593,17667330,526
1380,3482357,5,8385951,8386083,8386017,132
1381,3482357,5,21273650,21274748,21274199,1098
1382,3482358,1,19132705,19132874,19132789,169
1383,3482358,2,7489795,7489930,7489862,135
1384,3482358,2,10430287,10430357,10430322,70
1385,3482358,3,415898,416055,415976,157
1386,3482358,3,21580276,21583952,21582114,3676
1387,3482358,4,8054811,8055197,8055004,386
1388,3482358,5,4114437,4115552,4114994,1115
1389,3482359,1,180816,188108,184462,7292
1390,3482359,1,12130014,12130938,12130476,924
1391,3482359,1,28424539,28424837,28424688,298
1392,3482359,2,6033611,6034151,6033881,540
1393,3482359,3,1072316,1072490,1072403,174
1394,3482359,3,16580717,16581125,16580921,408
1395,3482359,4,5426726,5426998,5426862,272
1396,3482359,5,14064528,14064566,14064547,38
1397,3482359,5,19133465,19134392,19133928,927
1398,3482360,1,13068681,13068920,13068800,239
1399,3482360,2,9601581,9602207,9601894,626
1400,3482360,2,9908179,9908444,9908311,265
1401,3482360,3,3725745,3728057,3726901,2312
1402,3482360,3,4802226,4802257,4802241,31
1403,3482360,4,15031065,15034802,15032933,3737
1404,3482360,5,5436843,5438577,5437710,1734
1405,3482361,1,16440542,16440930,16440736,388
1406,3482361,1,24777183,24777278,24777230,95
1407,3482361,4,7064279,7065409,7064844,1130
1408,3482361,4,17673119,17673622,17673370,503
1409,3482361,5,4976073,4976699,4976386,626
1410,3482361,5,8153590,8155802,8154696,2212
1411,3482362,1,17921687,17931796,17926741,10109
1412,3482362,2,7996098,7996215,7996156,117
1413,3482362,3,5156118,5156156,5156137,38
1414,3482362,3,11096186,11096347,11096266,161
1415,3482362,5,5952942,5953703,5953322,761
1416,3482362,5,8733758,8733909,8733833,151
1417,3482362,5,24389762,24390430,24390096,668
1418,3482363,1,1574655,1575118,1574886,463
1419,3482363,1,25539022,25539380,25539201,358
1420,3482363,3,7598785,7598957,7598871,172
1421,3482363,3,15662182,15662326,15662254,144
1422,3482363,4,6965283,6965589,6965436,306
1423,3482364,1,1219574,1219863,1219718,289
1424,3482364,1,20002249,20002381,20002315,132
1425,3482364,2,7532784,7533157,7532970,373
1426,3482364,2,8429018,8429163,8429090,145
1427,3482364,3,9492805,9493114,9492959,309
1428,3482364,3,15940973,15940990,15940981,17
1429,3482364,3,19025669,19025741,19025705,72
1430,3482364,3,19995982,19997804,19996893,1822
1431,3482364,4,351884,352672,352278,788
1432,3482364,4,12499044,12499109,12499076,65
1433,3482364,4,13332535,13332658,13332596,123
1434,3482364,5,8316790,8316913,8316851,123
1435,3482364,5,26764420,26764716,26764568,296
1436,3482365,1,108053,108696,108374,643
1437,3482365,1,13122864,13123719,13123291,855
1438,3482365,1,17259632,17265476,17262554,5844
1439,3482365,1,27343478,27343612,27343545,134
1440,3482365,3,15699278,15699302,15699290,24
1441,3482365,3,17563474,17563501,17563487,27
1442,3482365,4,1212578,1213118,1212848,540
1443,3482365,4,8290686,8291466,8291076,780
1444,3482365,4,18458990,18459605,18459297,615
1445,3482365,5,343440,344770,344105,1330
1446,3482365,5,4902796,4906008,4904402,3212
1447,3482365,5,8655320,8655558,8655439,238
1448,3482365,5,18289844,18289855,18289849,11
1449,3482365,5,25946736,25947111,25946923,375
1450,3482366,1,11468137,11468212,11468174,75
1451,3482366,1,25672500,25673136,25672818,636
1452,3482366,2,2101040,2104067,2102553,3027
1453,3482366,2,6143650,6143874,6143762,224
1454,3482366,3,2595426,2596713,2596069,1287
1455,3482366,3,12100842,12100886,12100864,44
1456,3482366,3,17207541,17207649,17207595,108
1457,3482366,5,1717073,1717496,1717284,423
1458,3482366,5,6680673,6680963,6680818,290
1459,3482366,5,24996125,24996507,24996316,382
1460,3482367,1,24018526,24018619,24018572,93
1461,3482367,2,1599514,1600949,1600231,1435
1462,3482367,2,7041344,7041459,7041401,115
1463,3482367,2,18712412,18713070,18712741,658
1464,3482367,3,18556996,18557059,18557027,63
1465,3482367,5,1798521,1799982,1799251,1461
1466,3482367,5,15542576,15544855,15543715,2279
1467,3482368,1,28652550,28652585,28652567,35
1468,3482368,2,1599290,1599294,1599292,4
1469,3482368,2,8177544,8177938,8177741,394
1470,3482368,2,14320702,14320948,14320825,246
1471,3482368,3,7985589,7986566,7986077,977
1472,3482368,3,16552846,16552933,16552889,87
1473,3482368,3,21056327,21057232,21056779,905
1474,3482368,4,5230713,5231220,5230966,507
1475,3482368,4,7333570,7337062,7335316,3492
1476,3482368,5,16725516,16725675,16725595,159
1477,3482369,1,19815045,19816257,19815651,1212
1478,3482369,2,15293804,15293852,15293828,48
1479,3482369,3,1348238,1348471,1348354,233
1480,3482369,3,16236287,16238796,16237541,2509
1481,3482369,4,9320045,9320279,9320162,234
1482,3482369,5,9248917,9249003,9248960,86
1483,3482369,5,21320251,21320256,21320253,5
1484,3482370,1,19094144,19094912,19094528,768
1485,3482370,1,25239859,25240015,25239937,156
1486,3482370,2,290715,290811,290763,96
1487,3482370,2,7700834,7701485,7701159,651
1488,3482370,2,8351566,8351673,8351619,107
1489,3482370,2,9286704,9286948,9286826,244
1490,3482370,2,9882673,9884258,9883465,1585
1491,3482370,2,11117618,11118121,11117869,503
1492,3482370,2,11798947,11799017,11798982,70
1493,3482370,2,13784400,13785203,13784801,803
1494,3482370,2,14475204,14475818,14475511,614
1495,3482370,3,3468482,3469297,3468889,815
1496,3482370,3,3699777,3700754,3700265,977
1497,3482370,3,5286430,5288314,5287372,1884
1498,3482370,3,18221188,18221876,18221532,688
1499,3482370,3,21157877,21158211,21158044,334
1500,3482370,3,22367461,22368743,22368102,1282
1501,3482370,4,6318393,6318564,6318478,171
1502,3482370,4,6972211,6972256,6972233,45
1503,3482370,5,4815209,4815550,4815379,341
1504,3482370,5,7203982,7205991,7204986,2009
1505,3482370,5,24731643,24733657,24732650,2014
1506,3482372,1,7431427,7431439,7431433,12
1507,3482372,1,27979202,27979339,27979270,137
1508,3482372,2,17916844,17917120,17916982,276
1509,3482372,3,8288370,8288812,8288591,442
1510,3482372,3,8897724,8898570,8898147,846
1511,3482372,3,22922395,22922896,22922645,501
1512,3482372,4,127460,128068,127764,608
1513,3482372,4,16386662,16387655,16387158,993
1514,3482373,1,783499,784203,783851,704
1515,3482373,1,13076966,13077108,13077037,142
1516,3482373,2,985345,986322,985833,977
1517,3482373,2,7125584,7127889,7126736,2305
1518,3482373,3,1833836,1834862,1834349,1026
1519,3482373,3,2412052,2412335,2412193,283
1520,3482373,4,18053186,18054093,18053639,907
1521,3482373,5,18515447,18517542,18516494,2095
1522,3482373,5,22346646,22347291,22346968,645
1523,3482374,1,10681031,10681643,10681337,612
1524,3482374,2,6885498,6888868,6887183,3370
1525,3482374,3,8611639,8611695,8611667,56
1526,3482374,3,17740964,17741212,17741088,248
1527,3482374,3,22913802,22914343,22914072,541
1528,3482374,4,1041229,1043539,1042384,2310
1529,3482374,4,7550826,7550869,7550847,43
1530,3482375,1,3199315,3199348,3199331,33
1531,3482375,1,7203868,7203873,7203870,5
1532,3482375,1,9413786,9414996,9414391,1210
1533,3482375,1,26726312,26726664,26726488,352
1534,3482375,2,8252877,8254632,8253754,1755
1535,3482375,2,16718848,16720107,16719477,1259
1536,3482375,3,4877357,4877614,4877485,257
1537,3482375,3,16000170,16000181,16000175,11
1538,3482375,4,807209,807262,807235,53
1539,3482375,4,8160256,8160367,8160311,111
1540,3482375,5,7831503,7831891,7831697,388
1541,3482375,5,15775553,15775677,15775615,124
1542,3482376,1,4897356,4900870,4899113,3514
1543,3482376,1,20154839,20155239,20155039,400
1544,3482376,2,8257758,8259264,8258511,1506
1545,3482376,3,1177533,1177790,1177661,257
1546,3482376,3,16503552,16503665,16503608,113
1547,3482376,4,5404932,5405590,5405261,658
1548,3482376,4,9505598,9505804,9505701,206
1549,3482376,5,4106191,4106200,4106195,9
1550,3482376,5,4128613,4128808,4128710,195
1551,3482376,5,7117559,7117811,7117685,252
1552,3482376,5,15940308,15940342,15940325,34
1553,3482376,5,22904158,22904363,22904260,205
1554,3482377,1,29318272,29321205,29319738,2933
1555,3482377,2,7221317,7221639,7221478,322
1556,3482377,3,7851553,7864457,7858005,12904
1557,3482377,3,8894853,8895050,8894951,197
1558,3482377,5,24589771,24590939,24590355,1168
1559,3482378,1,7028531,7028768,7028649,237
1560,3482378,1,24237371,24237969,24237670,598
1561,3482378,2,915297,915418,915357,121
1562,3482378,2,7993420,7994097,7993758,677
1563,3482378,2,10687773,10687861,10687817,88
1564,3482378,3,8588868,8589246,8589057,378
1565,3482378,5,8052037,8052081,8052059,44
1566,3482378,5,20414850,20415386,20415118,536
1567,3482378,5,21730554,21730614,21730584,60
1568,3482379,1,8004169,8004185,8004177,16
1569,3482379,1,10711854,10712485,10712169,631
1570,3482379,2,276641,277220,276930,579
1571,3482379,2,7755449,7756013,7755731,564
1572,3482379,2,12775256,12775267,12775261,11
1573,3482379,3,5858327,5860008,5859167,1681
1574,3482379,4,6972617,6972651,6972634,34
1575,3482379,5,5814099,5815205,5814652,1106
1576,3482379,5,8846258,8846590,8846424,332
1577,3482379,5,26515905,26516009,26515957,104
1578,3482380,1,8974329,8974855,8974592,526
1579,3482380,1,22217417,22217635,22217526,218
1580,3482380,1,25153765,25154109,25153937,344
1581,3482380,2,204042,204126,204084,84
1582,3482380,3,5975350,5975620,5975485,270
1583,3482380,3,23173616,23175277,23174446,1661
1584,3482380,5,8412623,8413066,8412844,443
1585,3482380,5,18738933,18740459,18739696,1526
1586,3482381,1,3539882,3540404,3540143,522
1587,3482381,1,17188739,17189169,17188954,430
1588,3482381,2,18260466,18260762,18260614,296
1589,3482381,3,9496157,9497318,9496737,1161
1590,3482381,3,18421040,18421484,18421262,444
1591,3482381,4,18000059,18000922,18000490,863
1592,3482381,5,5770834,5771369,5771101,535
1593,3482381,5,9084985,9085437,9085211,452
1594,3482381,5,18593691,18593973,18593832,282
1595,3482382,2,15252738,15252951,15252844,213
1596,3482382,3,6715994,6716492,6716243,498
1597,3482382,3,9413692,9415139,9414415,1447
1598,3482382,3,19407159,19409443,19408301,2284
1599,3482382,4,4823979,4824576,4824277,597
1600,3482382,5,6873361,6873617,6873489,256
1601,3482382,5,23811349,23811356,23811352,7
1602,3482383,1,5168273,5170703,5169488,2430
1603,3482383,2,6926581,6926921,6926751,340
1604,3482383,2,12386990,12387015,12387002,25
1605,3482383,3,5991752,5991810,5991781,58
1606,3482383,3,9604442,9604705,9604573,263
1607,3482383,4,237114,237336,237225,222
1608,3482383,4,7254396,7255626,7255011,1230
1609,3482383,5,8750344,8750473,8750408,129
1610,3482383,5,24992341,24992881,24992611,540
1611,3482387,1,2236793,2237321,2237057,528
1612,3482387,1,11625104,11625219,11625161,115
1613,3482387,1,13045577,13046679,13046128,1102
1614,3482387,2,2323558,2323585,2323571,27
1615,3482387,2,18313360,18313472,18313416,112
1616,3482387,3,4895016,4896022,4895519,1006
1617,3482387,5,4113673,4114147,4113910,474
1618,3482387,5,10263064,10263147,10263105,83
1619,3482387,5,24082615,24082800,24082707,185
1620,3482388,2,7522123,7522799,7522461,676
1621,3482388,2,15084843,15085187,15085015,344
1622,3482388,3,9894866,9894925,9894895,59
1623,3482388,4,17677680,17678216,17677948,536
1624,3482388,5,1609355,1609463,1609409,108
1625,3482388,5,5307293,5307508,5307400,215
1626,3482388,5,20408618,20408668,20408643,50
1627,3482389,2,1137771,1140420,1139095,2649
1628,3482389,3,11805979,11807309,11806644,1330
1629,3482389,3,16648868,16648904,16648886,36
1630,3482389,5,15632129,15632615,15632372,486
1631,3482390,1,8935765,8936352,8936058,587
1632,3482390,1,20141534,20142766,20142150,1232
1633,3482390,2,5050038,5050117,5050077,79
1634,3482390,3,6788391,6790085,6789238,1694
1635,3482390,3,8605717,8605938,8605827,221
1636,3482390,5,4179194,4180009,4179601,815
1637,3482390,5,21981480,21981653,21981566,173
1638,3482391,1,16131373,16132256,16131814,883
1639,3482391,1,28853789,28854290,28854039,501
1640,3482391,2,877114,877312,877213,198
1641,3482391,2,6940588,6940609,6940598,21
1642,3482391,3,4869618,4869709,4869663,91
1643,3482391,3,16251410,16251446,16251428,36
1644,3482391,4,7221267,7221666,7221466,399
1645,3482391,4,10022021,10022203,10022112,182
1646,3482391,5,7867732,7867989,7867860,257
1647,3482391,5,7911910,7912847,7912378,937
1648,3482391,5,21318605,21318748,21318676,143
1649,3482391,5,21327484,21327881,21327682,397
1650,3482391,5,25502827,25503091,25502959,264
1651,3482391,5,26030824,26030827,26030825,3
1652,3482392,1,4709570,4709988,4709779,418
1653,3482392,1,8546229,8547011,8546620,782
1654,3482392,1,23077367,23077413,23077390,46
1655,3482392,1,24849384,24849532,24849458,148
1656,3482392,2,7879877,7880202,7880039,325
1657,3482392,2,11691854,11691864,11691859,10
1658,3482392,2,14122605,14123516,14123060,911
1659,3482392,3,6485159,6485431,6485295,272
1660,3482392,3,12100886,12101144,12101015,258
1661,3482392,3,16566917,16566947,16566932,30
1662,3482392,4,17322769,17323569,17323169,800
1663,3482392,5,8657976,8659230,8658603,1254
1664,3482392,5,14546425,14548320,14547372,1895
1665,3482393,3,7855369,7864457,7859913,9088
1666,3482393,3,19924300,19924350,19924325,50
1667,3482393,4,7871691,7872176,7871933,485
1668,3482393,5,17121149,17121608,17121378,459
1669,3482394,1,4943495,4943754,4943624,259
1670,3482394,1,12459267,12459361,12459314,94
1671,3482394,1,26503738,26503837,26503787,99
1672,3482394,2,7275081,7275141,7275111,60
1673,3482394,3,9022981,9023030,9023005,49
1674,3482394,4,1245071,1245087,1245079,16
1675,3482394,4,7035214,7035471,7035342,257
1676,3482394,5,15972410,15974789,15973599,2379
1677,3482394,5,22189948,22190259,22190103,311
1678,3482395,1,13254750,13254785,13254767,35
1679,3482395,2,6032905,6032921,6032913,16
1680,3482395,2,9561269,9561329,9561299,60
1681,3482395,3,8110450,8110544,8110497,94
1682,3482395,3,8928632,8928766,8928699,134
1683,3482395,4,5748460,5749677,5749068,1217
1684,3482395,5,16181371,16181579,16181475,208
1685,3482396,1,12073267,12073797,12073532,530
1686,3482396,1,26659991,26661046,26660518,1055
1687,3482396,2,5832919,5832998,5832958,79
1688,3482396,2,9577746,9577779,9577762,33
1689,3482396,3,16964802,16964946,16964874,144
1690,3482396,4,9700295,9700997,9700646,702
1691,3482396,4,14187651,14187681,14187666,30
1692,3482396,5,661052,661139,661095,87
1693,3482396,5,9864085,9864347,9864216,262
1694,3482396,5,15841842,15841987,15841914,145
1695,3482397,1,11570619,11570981,11570800,362
1696,3482397,2,10215447,10215457,10215452,10
1697,3482397,3,21775736,21777736,21776736,2000
1698,3482397,4,12969037,12969185,12969111,148
1699,3482397,5,546630,546986,546808,356
1700,3482397,5,8774788,8774995,8774891,207
1701,3482398,1,8692331,8692631,8692481,300
1702,3482398,1,17228253,17228505,17228379,252
1703,3482398,1,30414490,30414864,30414677,374
1704,3482398,2,7255221,7255778,7255499,557
1705,3482398,3,10856365,10856703,10856534,338
1706,3482398,4,16701347,16701713,16701530,366
1707,3482398,5,26595864,26595887,26595875,23
1708,3482399,1,11460849,11460931,11460890,82
1709,3482399,1,26330784,26331428,26331106,644
1710,3482399,3,19252936,19253341,19253138,405
1711,3482399,4,7521981,7521994,7521987,13
1712,3482399,4,10464982,10465170,10465076,188
1713,3482399,4,17670005,17670233,17670119,228
1714,3482399,5,1922754,1922966,1922860,212
1715,3482399,5,25190650,25191390,25191020,740
1716,3482400,1,10831482,10831576,10831529,94
1717,3482400,2,2757939,2758245,2758092,306
1718,3482400,2,9226298,9227412,9226855,1114
1719,3482400,2,11086207,11086280,11086243,73
1720,3482400,2,11740768,11741171,11740969,403
1721,3482400,2,13580470,13580485,13580477,15
1722,3482400,3,7289259,7289265,7289262,6
1723,3482400,4,5152139,5153012,5152575,873
1724,3482400,5,2209441,2209636,2209538,195
1725,3482400,5,3796248,3796277,3796262,29
1726,3482400,5,6022914,6023430,6023172,516
1727,3482400,5,7052826,7052943,7052884,117
1728,3482400,5,9831811,9831922,9831866,111
1729,3482400,5,19184602,19184758,19184680,156
1730,3482401,1,1100093,1100351,1100222,258
1731,3482401,1,8511222,8511274,8511248,52
1732,3482401,2,2179984,2181177,2180580,1193
1733,3482401,3,7284012,7284148,7284080,136
1734,3482401,3,19699449,19699589,19699519,140
1735,3482401,4,5156777,5156959,5156868,182
1736,3482401,4,5366209,5367031,5366620,822
1737,3482401,5,1569511,1569740,1569625,229
1738,3482401,5,23261700,23262867,23262283,1167
1739,3482402,1,11859371,11859630,11859500,259
1740,3482402,2,16409678,16409873,16409775,195
1741,3482402,4,8361250,8361266,8361258,16
1742,3482403,1,7708394,7709155,7708774,761
1743,3482403,1,16789358,16790658,16790008,1300
1744,3482403,1,25633097,25634039,25633568,942
1745,3482403,2,83342,83347,83344,5
1746,3482403,2,6306611,6310921,6308766,4310
1747,3482403,2,8304086,8304840,8304463,754
1748,3482403,2,19063672,19063703,19063687,31
1749,3482403,3,7817587,7819492,7818539,1905
1750,3482403,4,5759425,5759511,5759468,86
1751,3482403,4,6519332,6519594,6519463,262
1752,3482403,4,12312055,12312112,12312083,57
1753,3482403,5,22918469,22919124,22918796,655
1754,3482404,1,7805037,7805131,7805084,94
1755,3482404,1,27302517,27305144,27303830,2627
1756,3482404,2,11038375,11038451,11038413,76
1757,3482404,2,14855900,14856639,14856269,739
1758,3482404,3,10124619,10126944,10125781,2325
1759,3482404,3,11112857,11112882,11112869,25
1760,3482404,4,10944168,10945773,10944970,1605
1761,3482405,2,447361,447725,447543,364
1762,3482405,3,9041872,9042189,9042030,317
1763,3482405,3,17949978,17950367,17950172,389
1764,3482405,3,18664899,18668323,18666611,3424
1765,3482405,3,22460923,22461396,22461159,473
1766,3482405,4,8645593,8645876,8645734,283
1767,3482405,5,5793017,5794727,5793872,1710
1768,3482405,5,8580851,8581660,8581255,809
1769,3482405,5,18762186,18762217,18762201,31
1770,3482406,1,6854159,6854581,6854370,422
1771,3482406,2,1571126,1571197,1571161,71
1772,3482406,2,14492989,14493177,14493083,188
1773,3482406,3,5568892,5568989,5568940,97
1774,3482406,4,17451702,17453953,17452827,2251
1775,3482406,5,977616,977816,977716,200
1776,3482406,5,2446893,2447457,2447175,564
1777,3482406,5,10631730,10631795,10631762,65
1778,3482407,1,9164916,9166436,9165676,1520
1779,3482407,1,29782594,29782698,29782646,104
1780,3482407,2,906652,907254,906953,602
1781,3482407,2,17755686,17756315,17756000,629
1782,3482407,3,7550391,7551115,7550753,724
1783,3482407,3,10887330,10887554,10887442,224
1784,3482407,4,708867,708885,708876,18
1785,3482407,4,7855899,7857739,7856819,1840
1786,3482407,4,17548858,17548885,17548871,27
1787,3482407,5,5686631,5687712,5687171,1081
1788,3482408,1,7106533,7106567,7106550,34
1789,3482408,1,19364918,19364999,19364958,81
1790,3482408,1,29175918,29176661,29176289,743
1791,3482408,3,17212581,17212929,17212755,348
1792,3482408,4,10731074,10731132,10731103,58
1793,3482408,5,25436381,25436840,25436610,459
1794,3482409,1,8972755,8972918,8972836,163
1795,3482409,1,16481280,16482946,16482113,1666
1796,3482409,1,29209535,29210295,29209915,760
1797,3482409,2,16333555,16333696,16333625,141
1798,3482409,2,18307523,18308756,18308139,1233
1799,3482409,3,16922849,16923166,16923007,317
1800,3482409,3,21342650,21342708,21342679,58
1801,3482409,4,42077,42570,42323,493
1802,3482409,4,5602478,5602487,5602482,9
1803,3482409,5,2679614,2680272,2679943,658
1804,3482409,5,7750462,7752138,7751300,1676
1805,3482409,5,10282484,10283332,10282908,848
1806,3482410,1,5642243,5642267,5642255,24
1807,3482410,1,16888306,16888384,16888345,78
1808,3482410,1,19470288,19471946,19471117,1658
1809,3482410,1,28359959,28360230,28360094,271
1810,3482410,3,10302409,10302693,10302551,284
1811,3482410,4,8834827,8835255,8835041,428
1812,3482410,5,2318157,2318617,2318387,460
1813,3482410,5,10386287,10386806,10386546,519
1814,3482410,5,20912615,20912932,20912773,317
1815,3482412,1,2844854,2844995,2844924,141
1816,3482412,1,19647575,19647750,19647662,175
1817,3482412,2,12136561,12136596,12136578,35
1818,3482412,3,4789938,4790495,4790216,557
1819,3482412,4,7482302,7482903,7482602,601
1820,3482412,4,16807301,16807855,16807578,554
1821,3482412,4,18008474,18008911,18008692,437
1822,3482412,5,22666232,22666259,22666245,27
1823,3482413,1,2820581,2820728,2820654,147
1824,3482413,1,19693071,19693237,19693154,166
1825,3482413,2,12134086,12134150,12134118,64
1826,3482413,3,4789498,4789502,4789500,4
1827,3482413,4,7482302,7482903,7482602,601
1828,3482413,4,16798706,16798975,16798840,269
1829,3482413,4,18005348,18007252,18006300,1904
1830,3482413,5,22655095,22655551,22655323,456
1831,3482414,1,29513981,29515325,29514653,1344
1832,3482414,2,111534,111558,111546,24
1833,3482414,2,6289522,6289746,6289634,224
1834,3482414,3,1353218,1353868,1353543,650
1835,3482414,3,6739578,6739822,6739700,244
1836,3482414,3,19238516,19238754,19238635,238
1837,3482414,4,5143455,5143504,5143479,49
1838,3482414,5,18564561,18564973,18564767,412
1839,3482414,5,23999499,23999670,23999584,171
1840,3482414,5,25701999,25702946,25702472,947
1841,3482415,1,2297403,2297523,2297463,120
1842,3482415,2,10424524,10425526,10425025,1002
1843,3482415,2,18116943,18118146,18117544,1203
1844,3482415,3,18506108,18506185,18506146,77
1845,3482415,4,11565981,11566076,11566028,95
1846,3482415,4,12398899,12399009,12398954,110
1847,3482415,5,1769165,1769773,1769469,608
1848,3482415,5,13855234,13855545,13855389,311
1849,3482415,5,21477177,21478045,21477611,868
1850,3482416,1,17576045,17577920,17576982,1875
1851,3482416,3,1062247,1062302,1062274,55
1852,3482416,3,3692154,3692506,3692330,352
1853,3482416,3,9782290,9782639,9782464,349
1854,3482416,4,17654398,17658972,17656685,4574
1855,3482416,5,3521480,3521841,3521660,361
1856,3482416,5,18621319,18622463,18621891,1144
1857,3482416,5,24420920,24421706,24421313,786
1858,3482417,1,7152423,7152505,7152464,82
1859,3482417,1,22868666,22868682,22868674,16
1860,3482417,2,1062277,1062584,1062430,307
1861,3482417,2,7216869,7217477,7217173,608
1862,3482417,2,7946958,7946996,7946977,38
1863,3482417,2,12164213,12164455,12164334,242
1864,3482417,3,16650608,16650892,16650750,284
1865,3482417,4,7268541,7268581,7268561,40
1866,3482417,5,21143398,21143681,21143539,283
1867,3482418,1,13257417,13257466,13257441,49
1868,3482418,1,25410387,25410641,25410514,254
1869,3482418,2,8177938,8178852,8178395,914
1870,3482418,2,18466753,18467590,18467171,837
1871,3482418,3,205388,205620,205504,232
1872,3482418,3,17168048,17168177,17168112,129
1873,3482418,4,7353398,7353405,7353401,7
1874,3482418,4,16687612,16687653,16687632,41
1875,3482418,5,5635980,5636919,5636449,939
1876,3482418,5,15909632,15909679,15909655,47
1877,3482419,1,19911408,19912314,19911861,906
1878,3482419,2,6520629,6520831,6520730,202
1879,3482419,3,1053803,1054190,1053996,387
1880,3482419,3,4713517,4715798,4714657,2281
1881,3482419,3,18067531,18067683,18067607,152
1882,3482419,4,6359978,6360181,6360079,203
1883,3482419,5,16613252,16613431,16613341,179
1884,3482420,1,6330281,6330366,6330323,85
1885,3482420,1,28384001,28384576,28384288,575
1886,3482420,1,30410152,30410357,30410254,205
1887,3482420,3,3156562,3156591,3156576,29
1888,3482420,3,10126944,10127385,10127164,441
1889,3482420,3,19489570,19491763,19490666,2193
1890,3482420,4,177785,177909,177847,124
1891,3482420,4,15488630,15488750,15488690,120
1892,3482420,5,7395988,7396492,7396240,504
1893,3482420,5,9458003,9458084,9458043,81
1894,3482421,1,11180475,11182598,11181536,2123
1895,3482421,3,15658622,15659004,15658813,382
1896,3482421,4,7936915,7937029,7936972,114
1897,3482421,5,9338490,9338977,9338733,487
1898,3482421,5,18060405,18061286,18060845,881
1899,3482422,1,8004169,8004185,8004177,16
1900,3482422,2,8087541,8087915,8087728,374
1901,3482422,2,18588647,18589170,18588908,523
1902,3482422,3,5589800,5590043,5589921,243
1903,3482422,5,5937557,5937840,5937698,283
1904,3482423,1,24997663,24997836,24997749,173
1905,3482423,2,9954463,9955800,9955131,1337
1906,3482423,3,9714536,9715631,9715083,1095
1907,3482423,3,10303984,10304623,10304303,639
1908,3482423,3,20802858,20803146,20803002,288
1909,3482423,4,7573394,7573424,7573409,30
1910,3482423,5,15813809,15813959,15813884,150
1911,3482424,1,1653831,1653951,1653891,120
1912,3482424,1,5393529,5393607,5393568,78
1913,3482424,2,12932007,12932451,12932229,444
1914,3482424,2,14703903,14704263,14704083,360
1915,3482424,3,7866523,7866577,7866550,54
1916,3482424,4,676836,676859,676847,23
1917,3482424,4,1528789,1529792,1529290,1003
1918,3482424,4,14625441,14625659,14625550,218
1919,3482424,4,18055324,18055456,18055390,132
1920,3482424,5,8733758,8733909,8733833,151
1921,3482425,1,17348092,17349438,17348765,1346
1922,3482425,2,8423972,8424089,8424030,117
1923,3482425,3,8618418,8618809,8618613,391
1924,3482425,3,21055822,21055910,21055866,88
1925,3482425,5,6050940,6050946,6050943,6
1926,3482425,5,16212122,16212223,16212172,101
1927,3482425,5,20458383,20458517,20458450,134
1928,3482426,1,10655766,10656786,10656276,1020
1929,3482426,1,16127302,16127874,16127588,572
1930,3482426,2,763667,763787,763727,120
1931,3482426,2,19264383,19264792,19264587,409
1932,3482426,3,11526062,11526182,11526122,120
1933,3482426,3,17685612,17686476,17686044,864
1934,3482426,4,11972451,11972753,11972602,302
1935,3482427,1,4346977,4347480,4347228,503
1936,3482427,1,10625776,10626231,10626003,455
1937,3482427,1,27182361,27183587,27182974,1226
1938,3482427,2,6305790,6306611,6306200,821
1939,3482427,2,17200171,17201749,17200960,1578
1940,3482427,3,10663842,10664848,10664345,1006
1941,3482427,4,7175503,7175541,7175522,38
1942,3482427,5,15221610,15222354,15221982,744
1943,3482427,5,26251264,26251333,26251298,69
1944,3482428,1,11529473,11529754,11529613,281
1945,3482428,2,7694158,7694185,7694171,27
1946,3482428,3,2008043,2008249,2008146,206
1947,3482428,3,18201720,18202999,18202359,1279
1948,3482428,3,23071650,23073451,23072550,1801
1949,3482428,4,1269680,1269758,1269719,78
1950,3482428,4,6704654,6704736,6704695,82
1951,3482428,5,1567734,1567791,1567762,57
1952,3482432,1,2520249,2520391,2520320,142
1953,3482432,1,11902953,11903456,11903204,503
1954,3482432,1,17253368,17253798,17253583,430
1955,3482432,2,7284846,7285994,7285420,1148
1956,3482432,3,8458556,8458722,8458639,166
1957,3482432,4,720213,720369,720291,156
1958,3482432,4,7312561,7312909,7312735,348
1959,3482432,4,16902399,16902518,16902458,119
1960,3482432,5,343382,343406,343394,24
1961,3482432,5,6328116,6329309,6328712,1193
1962,3482433,1,6430280,6430490,6430385,210
1963,3482433,1,17834401,17834532,17834466,131
1964,3482433,1,24902667,24902763,24902715,96
1965,3482433,2,8032552,8033693,8033122,1141
1966,3482433,3,16887024,16887212,16887118,188
1967,3482433,4,665239,665544,665391,305
1968,3482433,4,17464140,17464593,17464366,453
1969,3482434,1,1074146,1076505,1075325,2359
1970,3482434,1,11769823,11769926,11769874,103
1971,3482434,1,19302828,19302984,19302906,156
1972,3482434,2,9570475,9570579,9570527,104
1973,3482434,3,10351123,10351284,10351203,161
1974,3482434,3,19272449,19272553,19272501,104
1975,3482434,4,62333,62368,62350,35
1976,3482434,4,302100,302639,302369,539
1977,3482434,4,6820566,6820746,6820656,180
1978,3482434,5,16644097,16644193,16644145,96
1979,3482435,1,23721423,23721554,23721488,131
1980,3482435,1,29888839,29888865,29888852,26
1981,3482435,2,6685652,6686374,6686013,722
1982,3482435,2,8207083,8209349,8208216,2266
1983,3482435,2,18700911,18701372,18701141,461
1984,3482435,3,1546927,1546931,1546929,4
1985,3482435,3,16874806,16875618,16875212,812
1986,3482435,4,12620042,12620342,12620192,300
1987,3482435,5,10648245,10651028,10649636,2783
1988,3482436,1,2842887,2843126,2843006,239
1989,3482436,1,6649431,6649649,6649540,218
1990,3482436,1,22939831,22940028,22939929,197
1991,3482436,1,26045784,26045915,26045849,131
1992,3482436,2,15691836,15691973,15691904,137
1993,3482436,3,7216968,7219253,7218110,2285
1994,3482436,3,22923009,22924481,22923745,1472
1995,3482436,4,4839937,4840545,4840241,608
1996,3482436,4,8295055,8296563,8295809,1508
1997,3482436,5,7721773,7721847,7721810,74
1998,3482436,5,15920593,15920618,15920605,25
1999,3482436,5,26066197,26066209,26066203,12
2000,3482437,1,2954529,2954889,2954709,360
2001,3482437,1,11279143,11279459,11279301,316
2002,3482437,2,11476994,11478134,11477564,1140
2003,3482437,3,15957345,15957393,15957369,48
2004,3482437,4,10719602,10720199,10719900,597
2005,3482437,5,16334322,16334876,16334599,554
2006,3482438,2,2136479,2142697,2139588,6218
2007,3482438,3,9492069,9493114,9492591,1045
2008,3482438,5,18390744,18390850,18390797,106
2009,3482439,2,2190535,2190711,2190623,176
2010,3482439,2,6257810,6262410,6260110,4600
2011,3482439,2,17818533,17819386,17818959,853
2012,3482439,3,6546841,6547659,6547250,818
2013,3482439,3,14946261,14946890,14946575,629
2014,3482439,3,18375562,18375979,18375770,417
2015,3482439,4,10033357,10033699,10033528,342
2016,3482439,4,10528498,10528576,10528537,78
2017,3482439,5,5522694,5524623,5523658,1929
2018,3482439,5,16894326,16894991,16894658,665
2019,3482440,1,22401430,22401841,22401635,411
2020,3482440,2,613174,613419,613296,245
2021,3482440,3,18815665,18816266,18815965,601
2022,3482440,3,23032267,23032445,23032356,178
2023,3482440,4,1598650,1599918,1599284,1268
2024,3482440,4,12382095,12382189,12382142,94
2025,3482440,4,18191462,18192500,18191981,1038
2026,3482440,5,5997684,5997947,5997815,263
2027,3482440,5,25889414,25889654,25889534,240
2028,3482441,1,13079789,13080227,13080008,438
2029,3482441,1,29117407,29117434,29117420,27
2030,3482441,2,178553,179212,178882,659
2031,3482441,3,3654014,3654088,3654051,74
2032,3482441,4,6282849,6282902,6282875,53
2033,3482441,4,11289965,11290220,11290092,255
2034,3482442,2,6285365,6285839,6285602,474
2035,3482442,3,3402152,3403101,3402626,949
2036,3482442,3,12100806,12100842,12100824,36
2037,3482442,3,15626623,15626898,15626760,275
2038,3482442,4,712492,712612,712552,120
2039,3482442,5,4115552,4116142,4115847,590
2040,3482443,1,11687000,11687033,11687016,33
2041,3482443,1,17854434,17854440,17854437,6
2042,3482443,2,6793603,6795275,6794439,1672
2043,3482443,2,15924196,15925004,15924600,808
2044,3482443,3,8879157,8879361,8879259,204
2045,3482443,4,7864094,7865556,7864825,1462
2046,3482443,4,13191030,13191737,13191383,707
2047,3482443,5,4277813,4277934,4277873,121
2048,3482443,5,5369962,5372161,5371061,2199
2049,3482443,5,14982143,14983333,14982738,1190
2050,3482444,1,570157,571284,570720,1127
2051,3482444,1,11292784,11292831,11292807,47
2052,3482444,1,17863083,17863093,17863088,10
2053,3482444,1,23656048,23656694,23656371,646
2054,3482444,1,29811054,29811357,29811205,303
2055,3482444,2,7497783,7498635,7498209,852
2056,3482444,2,12404672,12404699,12404685,27
2057,3482444,3,21766965,21767052,21767008,87
2058,3482444,4,8873107,8873168,8873137,61
2059,3482444,5,669,721,695,52
2060,3482444,5,15719769,15722787,15721278,3018
2061,3482445,1,8594415,8594582,8594498,167
2062,3482445,1,11954853,11954862,11954857,9
2063,3482445,2,7516095,7516745,7516420,650
2064,3482445,2,9942039,9942427,9942233,388
2065,3482445,3,8926003,8926127,8926065,124
2066,3482445,4,221800,222388,222094,588
2067,3482445,4,5426726,5427017,5426871,291
2068,3482445,4,16582412,16583489,16582950,1077
2069,3482445,5,8811109,8811587,8811348,478
2070,3482445,5,25833251,25833817,25833534,566
2071,3482446,1,1948337,1948504,1948420,167
2072,3482446,1,19230521,19230560,19230540,39
2073,3482446,2,2294951,2294994,2294972,43
2074,3482446,2,8367977,8368815,8368396,838
2075,3482446,2,9666296,9667013,9666654,717
2076,3482446,3,202434,203515,202974,1081
2077,3482446,3,10403357,10403790,10403573,433
2078,3482446,4,17468311,17469906,17469108,1595
2079,3482446,5,9521576,9521779,9521677,203
2080,3482446,5,25318301,25318536,25318418,235
2081,3482447,1,16442541,16443663,16443102,1122
2082,3482447,1,28147377,28148400,28147888,1023
2083,3482447,2,12873047,12873997,12873522,950
2084,3482447,3,8482513,8483190,8482851,677
2085,3482447,3,8934365,8935068,8934716,703
2086,3482447,4,927577,927805,927691,228
2087,3482447,4,7521994,7522716,7522355,722
2088,3482447,5,5767423,5767778,5767600,355
2089,3482447,5,21452350,21452440,21452395,90
2090,3482448,1,12162667,12162686,12162676,19
2091,3482448,1,25301746,25302310,25302028,564
2092,3482448,2,1276605,1276746,1276675,141
2093,3482448,2,16780007,16780243,16780125,236
2094,3482448,3,7091203,7092629,7091916,1426
2095,3482448,3,10874055,10874111,10874083,56
2096,3482448,3,17900686,17900903,17900794,217
2097,3482448,4,5640821,5641241,5641031,420
2098,3482448,4,16916825,16917150,16916987,325
2099,3482448,5,6421630,6424418,6423024,2788
2100,3482448,5,14529534,14530678,14530106,1144
2101,3482448,5,24109829,24109846,24109837,17
2102,3482449,1,8353695,8354810,8354252,1115
2103,3482449,1,21173520,21173565,21173542,45
2104,3482449,3,7472362,7472825,7472593,463
2105,3482449,4,6663809,6664037,6663923,228
2106,3482449,4,17142253,17144833,17143543,2580
2107,3482449,5,1997282,1997808,1997545,526
2108,3482449,5,16273942,16274302,16274122,360
2109,3482450,1,11085339,11085393,11085366,54
2110,3482450,2,702700,702974,702837,274
2111,3482450,2,1151052,1151135,1151093,83
2112,3482450,3,1837019,1837084,1837051,65
2113,3482450,3,16895880,16896254,16896067,374
2114,3482450,4,132798,133129,132963,331
2115,3482450,4,13649998,13651179,13650588,1181
2116,3482450,4,16555075,16555308,16555191,233
2117,3482450,5,2346239,2346452,2346345,213
2118,3482450,5,4947593,4948308,4947950,715
2119,3482450,5,16003462,16003502,16003482,40
2120,3482451,1,10904177,10904441,10904309,264
2121,3482451,2,11915125,11915343,11915234,218
2122,3482451,3,1846879,1847826,1847352,947
2123,3482451,3,20041647,20041761,20041704,114
2124,3482451,5,1584150,1585702,1584926,1552
2125,3482452,1,7390046,7391671,7390858,1625
2126,3482452,1,12934199,12934392,12934295,193
2127,3482452,1,20190880,20190919,20190899,39
2128,3482452,2,2179984,2181177,2180580,1193
2129,3482452,2,17995439,17997522,17996480,2083
2130,3482452,3,9038878,9039750,9039314,872
2131,3482452,3,16048786,16049454,16049120,668
2132,3482452,4,9447810,9448188,9447999,378
2133,3482452,5,5473399,5474587,5473993,1188
2134,3482452,5,14535433,14535608,14535520,175
2135,3482453,1,4371291,4371658,4371474,367
2136,3482453,1,12316093,12316537,12316315,444
2137,3482453,2,835752,836067,835909,315
2138,3482453,2,5005611,5005953,5005782,342
2139,3482453,3,197102,198224,197663,1122
2140,3482453,3,15774178,15774236,15774207,58
2141,3482453,3,19910636,19911122,19910879,486
2142,3482453,4,5165967,5166637,5166302,670
2143,3482453,4,6863005,6863134,6863069,129
2144,3482453,5,4592348,4593603,4592975,1255
2145,3482453,5,21321022,21321023,21321022,1
2146,3482454,1,3190117,3190506,3190311,389
2147,3482454,1,9387529,9387595,9387562,66
2148,3482454,1,16641851,16642694,16642272,843
2149,3482454,1,24252953,24253071,24253012,118
2150,3482454,2,10218812,10219901,10219356,1089
2151,3482454,2,11889349,11889970,11889659,621
2152,3482454,2,19575584,19576203,19575893,619
2153,3482454,4,8045018,8045610,8045314,592
2154,3482458,1,29235059,29235458,29235258,399
2155,3482458,2,9458466,9459152,9458809,686
2156,3482458,2,15367737,15367996,15367866,259
2157,3482458,3,10735226,10735371,10735298,145
2158,3482458,3,20859441,20860136,20859788,695
2159,3482458,4,1409661,1412066,1410863,2405
2160,3482459,1,3739063,3739636,3739349,573
2161,3482459,1,19052229,19052805,19052517,576
2162,3482459,2,1124214,1124985,1124599,771
2163,3482459,2,9520875,9522856,9521865,1981
2164,3482459,2,9694295,9696066,9695180,1771
2165,3482459,3,10336757,10336923,10336840,166
2166,3482459,4,15546052,15546662,15546357,610
2167,3482459,5,9302929,9303059,9302994,130
2168,3482460,1,11955171,11955491,11955331,320
2169,3482460,1,26045232,26045246,26045239,14
2170,3482460,2,6034756,6035051,6034903,295
2171,3482460,3,9337106,9337333,9337219,227
2172,3482460,3,16576258,16576348,16576303,90
2173,3482460,4,8919130,8919477,8919303,347
2174,3482460,4,11273602,11273992,11273797,390
2175,3482460,5,6039814,6040182,6039998,368
2176,3482461,1,9704252,9704608,9704430,356
2177,3482461,1,15989262,15989469,15989365,207
2178,3482461,1,29441752,29442104,29441928,352
2179,3482461,2,2199702,2200096,2199899,394
2180,3482461,3,7923443,7924136,7923789,693
2181,3482461,3,10361509,10361673,10361591,164
2182,3482461,4,9479177,9479208,9479192,31
2183,3482461,5,7640750,7641188,7640969,438
2184,3482461,5,10875931,10876230,10876080,299
2185,3482461,5,17922149,17922472,17922310,323
2186,3482461,5,24976718,24976977,24976847,259
2187,3482462,1,28212407,28212489,28212448,82
2188,3482462,1,28631972,28632788,28632380,816
2189,3482462,2,5010535,5011688,5011111,1153
2190,3482462,2,10835511,10836282,10835896,771
2191,3482462,3,10311897,10312002,10311949,105
2192,3482462,3,15822347,15822773,15822560,426
2193,3482462,4,8472405,8472645,8472525,240
2194,3482462,4,15873400,15873447,15873423,47
2195,3482462,5,13776480,13776817,13776648,337
2196,3482463,1,26725907,26726045,26725976,138
2197,3482463,2,1660026,1661964,1660995,1938
2198,3482463,3,3433036,3434211,3433623,1175
2199,3482463,3,11138292,11138360,11138326,68
2200,3482463,4,6368900,6369305,6369102,405
2201,3482463,5,330456,330713,330584,257
2202,3482463,5,7230521,7230701,7230611,180
2203,3482463,5,22180808,22180843,22180825,35
2204,3482463,5,25875076,25875384,25875230,308
2205,3482464,1,151738,153232,152485,1494
2206,3482464,1,12518413,12518431,12518422,18
2207,3482464,1,12693309,12694483,12693896,1174
2208,3482464,2,266395,267679,267037,1284
2209,3482464,2,16348537,16348838,16348687,301
2210,3482464,3,8958679,8959224,8958951,545
2211,3482464,4,10945552,10945773,10945662,221
2212,3482464,5,4900062,4900514,4900288,452
2213,3482464,5,6562432,6562550,6562491,118
2214,3482464,5,16845017,16845064,16845040,47
2215,3482465,1,20569161,20572550,20570855,3389
2216,3482465,2,2350428,2350683,2350555,255
2217,3482465,2,8932390,8933040,8932715,650
2218,3482465,3,21717385,21717865,21717625,480
2219,3482465,5,2046991,2047117,2047054,126
2220,3482465,5,13937717,13937932,13937824,215
2221,3482465,5,22884685,22886924,22885804,2239
2222,3482466,2,1137771,1140420,1139095,2649
2223,3482466,2,7636108,7636240,7636174,132
2224,3482466,2,16720341,16720622,16720481,281
2225,3482466,3,516779,517154,516966,375
2226,3482466,3,8935172,8935217,8935194,45
2227,3482466,4,18459778,18460539,18460158,761
2228,3482466,5,4982943,4983115,4983029,172
2229,3482466,5,17708959,17709965,17709462,1006
2230,3482466,5,26368670,26368688,26368679,18
2231,3482467,1,17662769,17664378,17663573,1609
2232,3482467,1,27646518,27646782,27646650,264
2233,3482467,1,30278168,30278172,30278170,4
2234,3482467,2,545046,546765,545905,1719
2235,3482467,2,8687834,8688619,8688226,785
2236,3482467,3,9211564,9213039,9212301,1475
2237,3482467,3,19626549,19626874,19626711,325
2238,3482467,4,5429039,5429869,5429454,830
2239,3482467,4,8054811,8055197,8055004,386
2240,3482467,4,17811470,17813689,17812579,2219
2241,3482467,5,3410110,3412795,3411452,2685
2242,3482467,5,23011191,23011278,23011234,87
2243,3482468,1,9944831,9944871,9944851,40
2244,3482468,1,19135078,19136933,19136005,1855
2245,3482468,1,19557024,19557202,19557113,178
2246,3482468,2,14936321,14937028,14936674,707
2247,3482468,2,16769976,16770137,16770056,161
2248,3482468,3,8778814,8779197,8779005,383
2249,3482468,4,212128,212293,212210,165
2250,3482468,5,7370709,7370842,7370775,133
2251,3482468,5,15866340,15866460,15866400,120
2252,3482469,1,10094340,10096837,10095588,2497
2253,3482469,3,2841199,2843850,2842524,2651
2254,3482469,3,23220601,23220853,23220727,252
2255,3482469,4,6053195,6053662,6053428,467
2256,3482469,5,4967168,4967288,4967228,120
2257,3482469,5,14951698,14952041,14951869,343
2258,3482469,5,26131696,26132185,26131940,489
2259,3482470,1,4083110,4083480,4083295,370
2260,3482470,1,5868247,5868352,5868299,105
2261,3482470,1,11026920,11026937,11026928,17
2262,3482470,1,26666406,26666512,26666459,106
2263,3482470,2,2188902,2188987,2188944,85
2264,3482470,2,16644760,16644799,16644779,39
2265,3482470,3,16420735,16420798,16420766,63
2266,3482470,3,17943838,17944454,17944146,616
2267,3482470,5,15500213,15500220,15500216,7
2268,3482470,5,17886209,17886723,17886466,514
2269,3482471,1,770082,770282,770182,200
2270,3482471,1,22887244,22887583,22887413,339
2271,3482471,2,8097440,8097905,8097672,465
2272,3482471,3,1589853,1590299,1590076,446
2273,3482471,4,5993765,5994519,5994142,754
2274,3482471,5,15956496,15957051,15956773,555
2275,3482471,5,26492086,26492948,26492517,862
2276,3482472,1,4272434,4272454,4272444,20
2277,3482472,2,15589488,15590220,15589854,732
2278,3482472,3,11729781,11729924,11729852,143
2279,3482472,4,15433725,15434128,15433926,403
2280,3482472,5,592580,592629,592604,49
2281,3482472,5,9477497,9477609,9477553,112
2282,3482472,5,16003914,16004239,16004076,325
2283,3482472,5,26231915,26232084,26231999,169
2284,3482473,1,3862735,3863829,3863282,1094
2285,3482473,1,9897031,9897382,9897206,351
2286,3482473,1,24430540,24430592,24430566,52
2287,3482473,2,1124214,1124985,1124599,771
2288,3482473,2,6764214,6765443,6764828,1229
2289,3482473,3,3067659,3068132,3067895,473
2290,3482473,3,20602120,20603229,20602674,1109
2291,3482473,4,806860,806979,806919,119
2292,3482473,5,1602779,1603084,1602931,305
2293,3482473,5,4102763,4104308,4103535,1545
2294,3482473,5,4114437,4115552,4114994,1115
2295,3482474,1,468404,469286,468845,882
2296,3482474,2,16020708,16020737,16020722,29
2297,3482474,3,18871606,18871691,18871648,85
2298,3482474,5,16641348,16641936,16641642,588
2299,3482474,5,18703706,18704295,18704000,589
2300,3482475,1,1562057,1562108,1562082,51
2301,3482475,2,237584,237631,237607,47
2302,3482475,2,6641924,6641997,6641960,73
2303,3482475,2,15790898,15791152,15791025,254
2304,3482475,3,5933917,5934548,5934232,631
2305,3482475,3,19009291,19009750,19009520,459
2306,3482475,3,19990482,19991246,19990864,764
2307,3482475,4,6542479,6544764,6543621,2285
2308,3482475,5,460458,461007,460732,549
2309,3482476,2,8660847,8660875,8660861,28
2310,3482476,2,11344161,11345058,11344609,897
2311,3482476,3,19566983,19567270,19567126,287
2312,3482477,1,23582322,23582373,23582347,51
2313,3482477,2,15403373,15403922,15403647,549
2314,3482477,3,16986181,16986245,16986213,64
2315,3482477,3,17551986,17554186,17553086,2200
2316,3482477,5,941832,942588,942210,756
2317,3482477,5,9055306,9056453,9055879,1147
2318,3482477,5,21913611,21913762,21913686,151
2319,3482478,1,9796679,9797952,9797315,1273
2320,3482478,1,13259193,13263623,13261408,4430
2321,3482478,1,29274583,29276254,29275418,1671
2322,3482478,2,92517,92757,92637,240
2323,3482478,2,2300011,2300148,2300079,137
2324,3482478,3,9065449,9065505,9065477,56
2325,3482478,4,1245071,1245087,1245079,16
2326,3482478,4,10127918,10128813,10128365,895
2327,3482478,5,892413,894221,893317,1808
2328,3482478,5,7911910,7912931,7912420,1021
2329,3482478,5,14950473,14950483,14950478,10
2330,3482479,1,19686983,19687534,19687258,551
2331,3482479,2,8319389,8319594,8319491,205
2332,3482479,2,18627968,18629758,18628863,1790
2333,3482479,4,504691,504928,504809,237
2334,3482479,5,8864413,8866401,8865407,1988
2335,3482479,5,20646139,20646522,20646330,383
2336,3482479,5,22190259,22190979,22190619,720
2337,3482480,1,5979099,5979374,5979236,275
2338,3482480,1,25301402,25301844,25301623,442
2339,3482480,1,25973335,25973460,25973397,125
2340,3482480,3,7643984,7644029,7644006,45
2341,3482480,4,117384,119508,118446,2124
2342,3482480,5,19286123,19286875,19286499,752
2343,3482480,5,23752153,23752412,23752282,259
2344,3482481,1,4044086,4044777,4044431,691
2345,3482481,1,7455656,7456193,7455924,537
2346,3482481,1,29646369,29650298,29648333,3929
2347,3482481,2,108976,110797,109886,1821
2348,3482481,2,12998576,12998958,12998767,382
2349,3482481,3,1928342,1928661,1928501,319
2350,3482481,3,4789938,4790495,4790216,557
2351,3482481,3,16990130,16990210,16990170,80
2352,3482481,4,671933,673698,672815,1765
2353,3482481,4,6257106,6257262,6257184,156
2354,3482481,4,12395354,12396504,12395929,1150
2355,3482481,5,8340801,8340978,8340889,177
2356,3482481,5,15996685,15996936,15996810,251
2357,3482481,5,17241988,17242034,17242011,46
2358,3482481,5,24357436,24357567,24357501,131
2359,3482482,1,2674334,2674356,2674345,22
2360,3482482,1,11111078,11111663,11111370,585
2361,3482482,3,8129396,8129407,8129401,11
2362,3482482,3,21700356,21702228,21701292,1872
2363,3482482,4,17024290,17025160,17024725,870
2364,3482482,5,25337139,25337432,25337285,293
2365,3482483,1,17008624,17008702,17008663,78
2366,3482483,1,24885832,24885854,24885843,22
2367,3482483,2,267924,268003,267963,79
2368,3482483,3,3622627,3622686,3622656,59
2369,3482483,3,11485112,11486832,11485972,1720
2370,3482483,3,20355473,20355826,20355649,353
2371,3482483,4,256116,256287,256201,171
2372,3482483,4,6742845,6742865,6742855,20
2373,3482483,5,18276844,18277632,18277238,788
2374,3482485,1,1539269,1539296,1539282,27
2375,3482485,1,10634104,10634179,10634141,75
2376,3482485,1,17373930,17374203,17374066,273
2377,3482485,2,7240836,7240904,7240870,68
2378,3482485,3,3683495,3685462,3684478,1967
2379,3482485,3,15888402,15888512,15888457,110
2380,3482485,4,8850941,8852836,8851888,1895
2381,3482485,5,7690905,7690967,7690936,62
2382,3482485,5,24816814,24816913,24816863,99
2383,3482486,1,10189185,10189877,10189531,692
2384,3482486,3,1193571,1193727,1193649,156
2385,3482486,3,4292915,4293286,4293100,371
2386,3482486,3,11351548,11351646,11351597,98
2387,3482486,3,18960323,18961493,18960908,1170
2388,3482486,4,10058777,10060637,10059707,1860
2389,3482486,4,13526883,13526921,13526902,38
2390,3482486,5,8131781,8134783,8133282,3002
2391,3482487,1,17229846,17230891,17230368,1045
2392,3482487,2,7088080,7088107,7088093,27
2393,3482487,2,17594313,17594343,17594328,30
2394,3482487,2,19336176,19336329,19336252,153
2395,3482487,3,4981772,4982018,4981895,246
2396,3482487,5,9621191,9622587,9621889,1396
2397,3482487,5,26291286,26291554,26291420,268
2398,3482491,1,8518020,8518264,8518142,244
2399,3482491,1,29766553,29766860,29766706,307
2400,3482491,2,5597101,5599659,5598380,2558
2401,3482491,2,19046378,19046878,19046628,500
2402,3482491,3,11775053,11775341,11775197,288
2403,3482491,3,15656893,15657365,15657129,472
2404,3482491,4,1407741,1408450,1408095,709
2405,3482491,4,10161110,10162487,10161798,1377
2406,3482491,4,17661569,17661623,17661596,54
2407,3482491,5,9432252,9434991,9433621,2739
2408,3482492,1,765612,765718,765665,106
2409,3482492,1,16447315,16447349,16447332,34
2410,3482492,1,29372412,29372559,29372485,147
2411,3482492,2,11618716,11619363,11619039,647
2412,3482492,2,18446054,18446211,18446132,157
2413,3482492,4,1201107,1201160,1201133,53
2414,3482492,4,16497314,16498013,16497663,699
2415,3482492,5,8780967,8781505,8781236,538
2416,3482492,5,17941826,17942654,17942240,828
2417,3482492,5,26901078,26901214,26901146,136
2418,3482493,1,6894281,6894317,6894299,36
2419,3482493,1,11415735,11415837,11415786,102
2420,3482493,1,19688034,19691145,19689589,3111
2421,3482493,2,7394015,7394084,7394049,69
2422,3482493,4,5151873,5152139,5152006,266
2423,3482493,5,1433738,1435137,1434437,1399
2424,3482493,5,7405390,7407810,7406600,2420
2425,3482493,5,25547695,25549012,25548353,1317
2426,3482494,1,24528864,24535811,24532337,6947
2427,3482494,2,6686957,6687770,6687363,813
2428,3482494,3,575511,575554,575532,43
2429,3482494,3,20379241,20380359,20379800,1118
2430,3482494,4,8529284,8531497,8530390,2213
2431,3482495,1,12593546,12593884,12593715,338
2432,3482495,1,29328620,29329862,29329241,1242
2433,3482495,4,739223,739367,739295,144
2434,3482495,5,16705,18695,17700,1990
2435,3482495,5,15760434,15760670,15760552,236
2436,3482495,5,19934064,19935885,19934974,1821
2437,3482496,1,558489,562860,560674,4371
2438,3482496,1,13276862,13277664,13277263,802
2439,3482496,2,10651647,10653318,10652482,1671
2440,3482496,2,15909246,15909465,15909355,219
2441,3482496,4,6869857,6869962,6869909,105
2442,3482496,4,12118898,12118940,12118919,42
2443,3482496,5,26513604,26513624,26513614,20
2444,3482497,1,11737974,11738765,11738369,791
2445,3482497,1,18240108,18240219,18240163,111
2446,3482497,1,21886371,21886882,21886626,511
2447,3482497,3,652429,653012,652720,583
2448,3482497,3,5755584,5756531,5756057,947
2449,3482497,3,22919154,22919972,22919563,818
2450,3482497,4,6098440,6098461,6098450,21
2451,3482497,4,7282662,7282733,7282697,71
2452,3482497,5,3455786,3455967,3455876,181
2453,3482498,1,5204629,5204684,5204656,55
2454,3482498,1,12581549,12581687,12581618,138
2455,3482498,1,18037548,18037609,18037578,61
2456,3482498,1,22996024,22996539,22996281,515
2457,3482498,2,16080312,16080407,16080359,95
2458,3482498,2,16492401,16495483,16493942,3082
2459,3482498,4,5371956,5371966,5371961,10
2460,3482498,4,16198540,16198815,16198677,275
2461,3482498,5,7311785,7312003,7311894,218
2462,3482499,1,4387324,4388565,4387944,1241
2463,3482499,1,10211457,10213494,10212475,2037
2464,3482499,1,16576051,16577766,16576908,1715
2465,3482499,2,2293721,2293784,2293752,63
2466,3482499,4,8450215,8450668,8450441,453
2467,3482499,5,361226,361701,361463,475
2468,3482500,1,6163340,6163701,6163520,361
2469,3482500,1,25562865,25563438,25563151,573
2470,3482500,2,18849338,18849412,18849375,74
2471,3482500,3,7222337,7222622,7222479,285
2472,3482500,3,11403278,11403280,11403279,2
2473,3482500,3,11867485,11867498,11867491,13
2474,3482500,3,23077647,23077803,23077725,156
2475,3482500,4,5457408,5457660,5457534,252
2476,3482500,4,8121550,8121868,8121709,318
2477,3482500,4,16168021,16168354,16168187,333
2478,3482500,5,10164432,10164720,10164576,288
2479,3482500,5,16584413,16585001,16584707,588
2480,3482500,5,22519901,22521936,22520918,2035
2481,3482501,1,18861478,18863001,18862239,1523
2482,3482501,2,323650,324509,324079,859
2483,3482501,4,177785,177937,177861,152
2484,3482501,4,6320626,6320627,6320626,1
2485,3482501,4,10393485,10394045,10393765,560
2486,3482501,5,5344927,5345341,5345134,414
2487,3482501,5,9305390,9307740,9306565,2350
2488,3482504,1,10866324,10867910,10867117,1586
2489,3482504,2,9375810,9376884,9376347,1074
2490,3482504,3,19533114,19534593,19533853,1479
2491,3482504,5,9155491,9156207,9155849,716
2492,3482504,5,19604617,19604653,19604635,36
2493,3482505,1,4044777,4045808,4045292,1031
2494,3482505,1,8107764,8109260,8108512,1496
2495,3482505,1,17211863,17212076,17211969,213
2496,3482505,2,2435962,2436149,2436055,187
2497,3482505,2,12896280,12899785,12898032,3505
2498,3482505,4,1602906,1603027,1602966,121
2499,3482505,4,17699900,17703787,17701843,3887
2500,3482505,5,21265014,21265086,21265050,72
2501,3482506,1,2761628,2762123,2761875,495
2502,3482506,1,22726651,22727742,22727196,1091
2503,3482506,2,1867715,1867994,1867854,279
2504,3482506,2,12813248,12813469,12813358,221
2505,3482506,3,9992367,9992403,9992385,36
2506,3482506,4,8032783,8033443,8033113,660
2507,3482506,4,17226296,17227430,17226863,1134
2508,3482506,5,4929002,4929488,4929245,486
2509,3482506,5,16166415,16167193,16166804,778
2510,3482506,5,26494221,26494900,26494560,679
2511,3482507,1,5237606,5237652,5237629,46
2512,3482507,3,5872714,5873364,5873039,650
2513,3482507,4,6014994,6015028,6015011,34
2514,3482507,5,9913960,9914013,9913986,53
2515,3482507,5,15216275,15221610,15218942,5335
2516,3482507,5,23046753,23046836,23046794,83
2517,3482508,2,449243,449367,449305,124
2518,3482508,3,2117645,2117758,2117701,113
2519,3482508,3,8040512,8040728,8040620,216
2520,3482508,3,11104380,11104496,11104438,116
2521,3482508,4,15018362,15019340,15018851,978
2522,3482508,5,184734,186442,185588,1708
2523,3482508,5,9878325,9879511,9878918,1186
2524,3482508,5,24731643,24732315,24731979,672
2525,3482509,1,10922311,10923908,10923109,1597
2526,3482509,2,273596,273849,273722,253
2527,3482509,2,2099643,2099712,2099677,69
2528,3482509,2,9541253,9541409,9541331,156
2529,3482509,2,16328729,16329376,16329052,647
2530,3482509,3,1382748,1383647,1383197,899
2531,3482509,3,2481828,2481875,2481851,47
2532,3482509,3,21061938,21062284,21062111,346
2533,3482509,4,1005819,1006168,1005993,349
2534,3482509,4,6512779,6512836,6512807,57
2535,3482509,5,6313973,6314430,6314201,457
2536,3482509,5,9874307,9874653,9874480,346
2537,3482509,5,25300697,25300953,25300825,256
2538,3482509,5,26695385,26697632,26696508,2247
2539,3482510,1,29442809,29443413,29443111,604
2540,3482510,2,5447293,5447402,5447347,109
2541,3482510,2,6699393,6700130,6699761,737
2542,3482510,4,9325335,9325452,9325393,117
2543,3482510,4,12332655,12332841,12332748,186
2544,3482510,5,9838430,9841842,9840136,3412
2545,3482511,1,1563875,1563967,1563921,92
2546,3482511,1,16444916,16444953,16444934,37
2547,3482511,1,26028129,26029101,26028615,972
2548,3482511,2,449367,449747,449557,380
2549,3482511,2,8918731,8918760,8918745,29
2550,3482511,2,17445044,17445226,17445135,182
2551,3482511,3,2554948,2555127,2555037,179
2552,3482511,3,22744128,22744605,22744366,477
2553,3482511,4,7849133,7849846,7849489,713
2554,3482511,5,9294907,9297487,9296197,2580
2555,3482512,1,12303211,12303361,12303286,150
2556,3482512,1,16134187,16134201,16134194,14
2557,3482512,1,30416898,30416933,30416915,35
2558,3482512,2,1381597,1382172,1381884,575
2559,3482512,3,22607727,22608088,22607907,361
2560,3482512,4,859104,859352,859228,248
2561,3482512,4,9740853,9741507,9741180,654
2562,3482512,4,11882027,11882624,11882325,597
2563,3482512,4,16287136,16287313,16287224,177
2564,3482512,5,9222021,9225785,9223903,3764
2565,3482513,1,2139569,2141179,2140374,1610
2566,3482513,1,11444922,11446481,11445701,1559
2567,3482513,1,29010173,29010208,29010190,35
2568,3482513,2,356120,356583,356351,463
2569,3482513,2,11754254,11755311,11754782,1057
2570,3482513,3,10311238,10312002,10311620,764
2571,3482513,3,16127723,16127766,16127744,43
2572,3482513,3,22221131,22222879,22222005,1748
2573,3482513,4,12411079,12411149,12411114,70
2574,3482513,5,16106561,16106719,16106640,158
2575,3482514,1,8376090,8376148,8376119,58
2576,3482514,1,18754996,18755003,18754999,7
2577,3482514,2,2898790,2899114,2898952,324
2578,3482514,2,18099510,18099963,18099736,453
2579,3482514,3,1540770,1540853,1540811,83
2580,3482514,4,6323619,6323646,6323632,27
2581,3482514,4,8970740,8971991,8971365,1251
2582,3482514,4,18200321,18204044,18202182,3723
2583,3482514,5,732968,733228,733098,260
2584,3482514,5,20691049,20691134,20691091,85
2585,3482514,5,21585702,21586561,21586131,859
2586,3482515,1,26242706,26242887,26242796,181
2587,3482515,2,7981060,7983102,7982081,2042
2588,3482515,2,11757499,11757550,11757524,51
2589,3482515,4,948966,952198,950582,3232
2590,3482515,5,9115479,9115867,9115673,388
2591,3482515,5,17570682,17570688,17570685,6
2592,3482516,1,17252428,17252626,17252527,198
2593,3482516,2,5645240,5645525,5645382,285
2594,3482516,2,8732438,8732542,8732490,104
2595,3482516,2,16829907,16830112,16830009,205
2596,3482516,3,4484021,4485333,4484677,1312
2597,3482516,5,9170586,9170588,9170587,2
2598,3482516,5,26265591,26266032,26265811,441
2599,3482517,2,2471239,2471343,2471291,104
2600,3482517,2,8622381,8622522,8622451,141
2601,3482517,2,18564875,18566794,18565834,1919
2602,3482517,3,16782311,16783730,16783020,1419
2603,3482517,3,19437858,19440122,19438990,2264
2604,3482517,4,7295416,7296913,7296164,1497
2605,3482517,4,11999955,12000067,12000011,112
2606,3482517,5,23299305,23299350,23299327,45
2607,3482518,1,8446242,8446449,8446345,207
2608,3482518,1,17226304,17228137,17227220,1833
2609,3482518,1,25645252,25645941,25645596,689
2610,3482518,5,14641503,14644953,14643228,3450
2611,3482519,1,10171405,10173151,10172278,1746
2612,3482519,1,24849673,24849922,24849797,249
2613,3482519,1,25746001,25746068,25746034,67
2614,3482519,2,12930433,12931276,12930854,843
2615,3482519,3,3460895,3460925,3460910,30
2616,3482519,5,6159593,6162486,6161039,2893
2617,3482520,1,6319553,6319598,6319575,45
2618,3482520,1,11214679,11215185,11214932,506
2619,3482520,1,24625631,24627678,24626654,2047
2620,3482520,2,6964737,6964858,6964797,121
2621,3482520,3,4601474,4603486,4602480,2012
2622,3482520,3,8175692,8176036,8175864,344
2623,3482520,4,5338752,5341604,5340178,2852
2624,3482520,4,9030374,9030549,9030461,175
2625,3482520,5,9276520,9276763,9276641,243
2626,3482520,5,19219058,19219402,19219230,344
2627,3482521,1,8486289,8486579,8486434,290
2628,3482521,1,23393775,23394692,23394233,917
2629,3482521,1,26912028,26912041,26912034,13
2630,3482521,2,548128,548269,548198,141
2631,3482521,2,18837230,18837301,18837265,71
2632,3482521,4,6640827,6640896,6640861,69
2633,3482521,5,13661946,13662424,13662185,478
2634,3482521,5,22177888,22177931,22177909,43
2635,3482522,1,6882947,6883276,6883111,329
2636,3482522,1,20894171,20894337,20894254,166
2637,3482522,1,21937321,21937370,21937345,49
2638,3482522,3,1584447,1584736,1584591,289
2639,3482522,3,6102292,6103230,6102761,938
2640,3482522,5,6725466,6728402,6726934,2936
2641,3482522,5,21400314,21401116,21400715,802
2642,3482523,1,8445388,8445588,8445488,200
2643,3482523,1,22707424,22708496,22707960,1072
2644,3482523,2,6813344,6814619,6813981,1275
2645,3482523,2,11564017,11565124,11564570,1107
2646,3482523,2,16158095,16158572,16158333,477
2647,3482523,5,9852257,9852480,9852368,223
2648,3482523,5,14983333,14984200,14983766,867
2649,3482523,5,20025704,20027366,20026535,1662
2650,3482524,1,9710630,9711282,9710956,652
2651,3482524,1,23047062,23047650,23047356,588
2652,3482524,2,6620062,6620218,6620140,156
2653,3482524,3,22461740,22461810,22461775,70
2654,3482524,4,868157,868337,868247,180
2655,3482524,4,13717664,13718341,13718002,677
2656,3482524,4,17445023,17445373,17445198,350
2657,3482524,5,24962857,24963310,24963083,453
2658,3482525,1,17530623,27673202,22601912,10142579
2659,3482525,2,6018173,6018933,6018553,760
2660,3482525,2,8668820,8668909,8668864,89
2661,3482525,3,1440156,1440427,1440291,271
2662,3482525,4,7341595,7341780,7341687,185
2663,3482525,4,9353795,9354807,9354301,1012
2664,3482525,5,647619,647672,647645,53
2665,3482525,5,15321285,15321564,15321424,279
2666,3482526,1,18915314,18915531,18915422,217
2667,3482526,1,26435247,26435585,26435416,338
2668,3482526,3,10193817,10193880,10193848,63
2669,3482526,4,5229766,5230128,5229947,362
2670,3482526,4,17467481,17467919,17467700,438
2671,3482526,5,9703366,9704450,9703908,1084
2672,3482526,5,22204540,22205216,22204878,676
2673,3482527,1,3929174,3929277,3929225,103
2674,3482527,1,10475076,10476433,10475754,1357
2675,3482527,1,22402110,22402356,22402233,246
2676,3482527,2,5652377,5653682,5653029,1305
2677,3482527,2,11739893,11739964,11739928,71
2678,3482527,3,618897,623080,620988,4183
2679,3482527,3,16622655,16625085,16623870,2430
2680,3482527,4,5405590,5405606,5405598,16
2681,3482527,4,8824699,8824882,8824790,183
2682,3482527,4,16286436,16286522,16286479,86
2683,3482527,5,15988604,15989325,15988964,721
2684,3482528,1,20041750,20042014,20041882,264
2685,3482528,1,22306626,22306685,22306655,59
2686,3482528,2,15139663,15140042,15139852,379
2687,3482528,3,7598267,7598759,7598513,492
2688,3482528,3,15994063,15994417,15994240,354
2689,3482528,3,20774954,20775186,20775070,232
2690,3482528,4,6354601,6354696,6354648,95
2691,3482528,5,9328115,9328807,9328461,692
2692,3482528,5,9809037,9809054,9809045,17
2693,3482528,5,26530613,26532250,26531431,1637
2694,3482529,1,8716274,8716384,8716329,110
2695,3482529,1,17367912,17368030,17367971,118
2696,3482529,1,24037189,24037255,24037222,66
2697,3482529,1,25234723,25234765,25234744,42
2698,3482529,2,1977007,1977094,1977050,87
2699,3482529,2,6257810,6262410,6260110,4600
2700,3482529,3,9037231,9037393,9037312,162
2701,3482529,3,16732596,16732860,16732728,264
2702,3482529,5,8944962,8945885,8945423,923
2703,3482529,5,21321020,21321022,21321021,2
2704,3482530,1,26327895,26327928,26327911,33
2705,3482530,2,1433017,1433713,1433365,696
2706,3482530,3,3685468,3685523,3685495,55
2707,3482530,3,11075971,11076478,11076224,507
2708,3482530,4,1436547,1437284,1436915,737
2709,3482530,4,10867508,10867670,10867589,162
2710,3482530,4,17814773,17815391,17815082,618
2711,3482530,5,8291908,8292400,8292154,492
2712,3482531,1,11920827,11921283,11921055,456
2713,3482531,1,16256042,16256076,16256059,34
2714,3482531,1,24220296,24220825,24220560,529
2715,3482531,2,9722294,9722529,9722411,235
2716,3482531,2,17052985,17054343,17053664,1358
2717,3482531,4,288365,289261,288813,896
2718,3482531,5,7694273,7695029,7694651,756
2719,3482532,1,29638218,29639193,29638705,975
2720,3482532,1,30349862,30349993,30349927,131
2721,3482532,2,332837,334781,333809,1944
2722,3482532,2,12246871,12247103,12246987,232
2723,3482532,2,19559640,19561771,19560705,2131
2724,3482532,3,7556409,7556678,7556543,269
2725,3482532,4,145745,146326,146035,581
2726,3482532,4,2355839,2355914,2355876,75
2727,3482532,4,3293994,3294117,3294055,123
2728,3482532,4,7202932,7203882,7203407,950
2729,3482532,4,11349485,11349634,11349559,149
2730,3482532,5,9607796,9608036,9607916,240
2731,3482532,5,10291394,10291541,10291467,147
2732,3482532,5,10538576,10538794,10538685,218
2733,3482532,5,13228564,13228657,13228610,93
2734,3482532,5,22050408,22050586,22050497,178
2735,3482533,1,2413611,2413793,2413702,182
2736,3482533,1,3621441,3621563,3621502,122
2737,3482533,1,13144368,13144548,13144458,180
2738,3482533,1,19812216,19814050,19813133,1834
2739,3482533,2,6524149,6524225,6524187,76
2740,3482533,2,7436091,7436406,7436248,315
2741,3482533,2,16028839,16028937,16028888,98
2742,3482533,3,7881653,7881961,7881807,308
2743,3482533,4,744173,746534,745353,2361
2744,3482533,4,5243476,5244091,5243783,615
2745,3482533,5,10137055,10139725,10138390,2670
2746,3482533,5,24439883,24440388,24440135,505
2747,3482534,1,19558469,19558524,19558496,55
2748,3482534,1,28918510,28919006,28918758,496
2749,3482534,3,1284153,1284285,1284219,132
2750,3482534,3,10994599,10994713,10994656,114
2751,3482534,3,20608256,20608473,20608364,217
2752,3482534,4,5150380,5151385,5150882,1005
2753,3482534,5,4396655,4396928,4396791,273
2754,3482534,5,26450704,26451304,26451004,600
2755,3482535,1,11963630,11967222,11965426,3592
2756,3482535,2,9562697,9562788,9562742,91
2757,3482535,2,16563337,16564796,16564066,1459
2758,3482535,3,1546639,1546715,1546677,76
2759,3482535,3,16298391,16299607,16298999,1216
2760,3482535,4,483189,483595,483392,406
2761,3482535,4,7279373,7279437,7279405,64
2762,3482535,5,24662175,24662241,24662208,66
2763,3482536,4,14107880,14108186,14108033,306
2764,3482537,1,25465429,25466318,25465873,889
2765,3482537,2,16463022,16464773,16463897,1751
2766,3482537,3,5424498,5425966,5425232,1468
2767,3482537,4,9292077,9292483,9292280,406
2768,3482538,1,8319250,8321457,8320353,2207
2769,3482538,1,9835290,9835326,9835308,36
2770,3482538,1,12248370,12248745,12248557,375
2771,3482538,1,12965602,12966058,12965830,456
2772,3482538,1,13433271,13434838,13434054,1567
2773,3482538,2,16449704,16449786,16449745,82
2774,3482538,2,18082780,18083200,18082990,420
2775,3482538,2,19057077,19058137,19057607,1060
2776,3482538,3,8407340,8409667,8408503,2327
2777,3482538,3,18782957,18783063,18783010,106
2778,3482538,5,10497583,10497616,10497599,33
2779,3482538,5,13236269,13237959,13237114,1690
2780,3482538,5,18045464,18045887,18045675,423
2781,3482538,5,26714373,26714464,26714418,91
2782,3482539,1,19880424,19880781,19880602,357
2783,3482539,1,25137213,25137289,25137251,76
2784,3482539,1,30409189,30409510,30409349,321
2785,3482539,2,18810636,18811061,18810848,425
2786,3482539,4,6048089,6048436,6048262,347
2787,3482539,4,6191743,6192115,6191929,372
2788,3482539,4,17610326,17610472,17610399,146
2789,3482539,5,5675317,5675338,5675327,21
2790,3482540,1,8958719,8958998,8958858,279
2791,3482540,2,6915452,6915708,6915580,256
2792,3482540,2,14545647,14545696,14545671,49
2793,3482540,3,2385884,2390461,2388172,4577
2794,3482540,4,16985506,16986522,16986014,1016
2795,3482540,5,8219074,8219306,8219190,232
2796,3482540,5,14231984,14239645,14235814,7661
2797,3482541,1,10013212,10013278,10013245,66
2798,3482541,1,17229599,17229825,17229712,226
2799,3482541,1,29369007,29369322,29369164,315
2800,3482541,2,10357971,10358526,10358248,555
2801,3482541,5,16535129,16535743,16535436,614
2802,3482541,5,19839941,19840310,19840125,369
2803,3482542,1,7747833,7748134,7747983,301
2804,3482542,1,29905074,29905221,29905147,147
2805,3482542,2,12010188,12010271,12010229,83
2806,3482542,3,8960989,8961924,8961456,935
2807,3482542,3,9713634,9713869,9713751,235
2808,3482542,4,586272,586939,586605,667
2809,3482542,4,596791,597583,597187,792
2810,3482543,1,19414482,19414989,19414735,507
2811,3482543,3,5963762,5963880,5963821,118
2812,3482543,4,189571,190004,189787,433
2813,3482543,5,13589062,13589179,13589120,117
2814,3482543,5,20497422,20498058,20497740,636
2815,3482544,1,16550842,16550894,16550868,52
2816,3482544,2,1031226,1031470,1031348,244
2817,3482544,4,8809845,8811815,8810830,1970
2818,3482544,5,13749867,13750806,13750336,939
2819,3482544,5,14287623,14288815,14288219,1192
2820,3482545,1,4224634,4224744,4224689,110
2821,3482545,1,11466761,11467127,11466944,366
2822,3482545,1,19444422,19445400,19444911,978
2823,3482545,2,1937636,1938150,1937893,514
2824,3482545,5,1131441,1132224,1131832,783
2825,3482546,1,13304625,13304942,13304783,317
2826,3482546,1,25765142,25765427,25765284,285
2827,3482546,1,28150033,28151760,28150896,1727
2828,3482546,2,2294951,2294994,2294972,43
2829,3482546,2,12842843,12843053,12842948,210
2830,3482546,3,5421952,5423976,5422964,2024
2831,3482546,3,10859075,10859247,10859161,172
2832,3482546,4,5378596,5379241,5378918,645
2833,3482546,5,21852876,21853133,21853004,257
2834,3482546,5,25458727,25459627,25459177,900
2835,3482547,1,5133524,5133573,5133548,49
2836,3482547,1,26333702,26333897,26333799,195
2837,3482547,1,27409914,27410156,27410035,242
2838,3482547,2,6245184,6245231,6245207,47
2839,3482547,3,11076718,11081105,11078911,4387
2840,3482547,3,16925472,16927305,16926388,1833
2841,3482547,5,14912193,14912488,14912340,295
2842,3482548,1,11332178,11332218,11332198,40
2843,3482548,1,26226159,26226521,26226340,362
2844,3482548,2,2350407,2350418,2350412,11
2845,3482548,2,6615185,6616141,6615663,956
2846,3482548,2,17973970,17974185,17974077,215
2847,3482548,3,10713593,10714019,10713806,426
2848,3482548,4,942519,943158,942838,639
2849,3482548,4,11946695,11947944,11947319,1249
2850,3482548,5,15866340,15866460,15866400,120
2851,3482548,5,24289162,24293085,24291123,3923
2852,3482549,1,9094410,9094514,9094462,104
2853,3482549,1,19102704,19102848,19102776,144
2854,3482549,2,8525039,8525670,8525354,631
2855,3482549,2,14347535,14348705,14348120,1170
2856,3482549,2,17063648,17064780,17064214,1132
2857,3482549,3,5247367,5247561,5247464,194
2858,3482549,3,9713592,9713634,9713613,42
2859,3482549,3,20520905,20521328,20521116,423
2860,3482549,4,178452,179032,178742,580
2861,3482549,5,495629,498171,496900,2542
2862,3482550,1,16914669,16916104,16915386,1435
2863,3482550,1,24809419,24809664,24809541,245
2864,3482550,1,26797823,26797901,26797862,78
2865,3482550,2,260241,261768,261004,1527
2866,3482550,3,4951465,4951532,4951498,67
2867,3482550,4,11762492,11762631,11762561,139
2868,3482550,5,4557612,4557709,4557660,97
2869,3482550,5,8764823,8764836,8764829,13
2870,3482550,5,20520063,20520428,20520245,365
2871,3482550,5,21605094,21605343,21605218,249
2872,3482551,1,18410076,18410128,18410102,52
2873,3482551,2,11901043,11901951,11901497,908
2874,3482551,2,15487122,15487607,15487364,485
2875,3482551,3,16533259,16533277,16533268,18
2876,3482551,3,18022726,18024510,18023618,1784
2877,3482551,4,11520602,11520617,11520609,15
2878,3482551,4,17245471,17248917,17247194,3446
2879,3482551,5,5406334,5407182,5406758,848
2880,3482551,5,14538941,14540461,14539701,1520
2881,3482551,5,21305936,21306205,21306070,269
2882,3482552,1,10880428,10880436,10880432,8
2883,3482552,1,16830774,16830871,16830822,97
2884,3482552,2,8583637,8584932,8584284,1295
2885,3482552,2,11859173,11859177,11859175,4
2886,3482552,4,10360117,10360891,10360504,774
2887,3482552,5,13774765,13776333,13775549,1568
2888,3482552,5,26515079,26515178,26515128,99
2889,3482553,1,29760301,29761025,29760663,724
2890,3482553,2,6806525,6807863,6807194,1338
2891,3482553,3,8947146,8947404,8947275,258
2892,3482553,4,6698401,6698988,6698694,587
2893,3482553,5,9398601,9404317,9401459,5716
2894,3482553,5,22919455,22919540,22919497,85
2895,3482554,3,5847056,5847250,5847153,194
2896,3482554,3,9054886,9057487,9056186,2601
2897,3482554,3,15411576,15411587,15411581,11
2898,3482554,5,797726,797844,797785,118
2899,3482555,1,23402042,23402056,23402049,14
2900,3482555,2,6987009,6987542,6987275,533
2901,3482555,2,18648884,18649090,18648987,206
2902,3482555,3,8233800,8234293,8234046,493
2903,3482555,3,19800481,19800771,19800626,290
2904,3482555,4,7367286,7369125,7368205,1839
2905,3482555,5,24374842,24374919,24374880,77
2906,3482556,1,7377457,7380087,7378772,2630
2907,3482556,1,10488985,10489198,10489091,213
2908,3482556,1,23586422,23586667,23586544,245
2909,3482556,2,6403979,6405430,6404704,1451
2910,3482556,3,22708968,22709307,22709137,339
2911,3482556,4,7247605,7247665,7247635,60
2912,3482556,4,17444262,17445373,17444817,1111
2913,3482557,1,7825585,7825633,7825609,48
2914,3482557,1,17266212,17266547,17266379,335
2915,3482557,2,7584618,7584993,7584805,375
2916,3482557,3,14784431,14784481,14784456,50
2917,3482557,4,5237147,5237293,5237220,146
2918,3482557,4,7863636,7865556,7864596,1920
2919,3482557,5,908767,909290,909028,523
2920,3482557,5,17586813,17586865,17586839,52
2921,3482558,1,11092356,11094815,11093585,2459
2922,3482558,1,26903321,26903771,26903546,450
2923,3482558,2,10149066,10149169,10149117,103
2924,3482558,2,18403977,18404054,18404015,77
2925,3482558,3,10220357,10220735,10220546,378
2926,3482558,3,21054442,21055768,21055105,1326
2927,3482558,4,11628430,11628431,11628430,1
2928,3482562,1,6576385,6577984,6577184,1599
2929,3482562,1,12003588,12003659,12003623,71
2930,3482562,2,2927798,2928473,2928135,675
2931,3482562,3,19993953,19994579,19994266,626
2932,3482563,1,9960236,9960524,9960380,288
2933,3482563,1,24407242,24407561,24407401,319
2934,3482563,2,15118717,15118997,15118857,280
2935,3482563,2,19063451,19063510,19063480,59
2936,3482563,3,8048071,8049389,8048730,1318
2937,3482563,4,6219392,6219679,6219535,287
2938,3482563,5,9014650,9015384,9015017,734
2939,3482564,1,8660923,8660939,8660931,16
2940,3482564,1,12612543,12614203,12613373,1660
2941,3482564,1,26209503,26209874,26209688,371
2942,3482564,2,11583212,11584111,11583661,899
2943,3482564,3,6885108,6885299,6885203,191
2944,3482564,3,9812347,9812694,9812520,347
2945,3482564,4,8994215,8994226,8994220,11
2946,3482564,5,9080798,9081030,9080914,232
2947,3482564,5,15934400,15934444,15934422,44
2948,3482564,5,21382886,21383090,21382988,204
2949,3482564,5,21478956,21479206,21479081,250
2950,3482565,1,28964103,28964855,28964479,752
2951,3482565,2,161796,162251,162023,455
2952,3482565,2,7050545,7050941,7050743,396
2953,3482565,3,3609596,3609917,3609756,321
2954,3482565,4,7367050,7367094,7367072,44
2955,3482565,4,7755470,7755576,7755523,106
2956,3482565,5,4128216,4128808,4128512,592
2957,3482565,5,13915548,13916892,13916220,1344
2958,3482565,5,17204025,17204072,17204048,47
2959,3482566,1,8914524,8914823,8914673,299
2960,3482566,2,9462151,9462223,9462187,72
2961,3482566,2,15143416,15144455,15143935,1039
2962,3482566,3,22874437,22874606,22874521,169
2963,3482566,4,7995139,7995267,7995203,128
2964,3482567,1,17006596,17007505,17007050,909
2965,3482567,1,19249545,19249587,19249566,42
2966,3482567,2,1926717,1926865,1926791,148
2967,3482567,2,10346781,10347150,10346965,369
2968,3482567,3,920200,923924,922062,3724
2969,3482567,3,16951618,16951655,16951636,37
2970,3482567,3,17253768,17254846,17254307,1078
2971,3482567,5,10472138,10472875,10472506,737
2972,3482568,1,8298608,8298793,8298700,185
2973,3482568,1,11184893,11185014,11184953,121
2974,3482568,1,28932250,28934610,28933430,2360
2975,3482568,2,18778849,18779350,18779099,501
2976,3482568,3,8956971,8957220,8957095,249
2977,3482568,3,17710280,17710752,17710516,472
2978,3482568,4,6991195,6991390,6991292,195
2979,3482568,4,9979331,9979434,9979382,103
2980,3482568,4,14698391,14698904,14698647,513
2981,3482568,5,461007,461320,461163,313
2982,3482568,5,6611335,6614686,6613010,3351
2983,3482568,5,15621230,15621643,15621436,413
2984,3482568,5,24503395,24504241,24503818,846
2985,3482569,1,1241208,1241922,1241565,714
2986,3482569,1,16165740,16165835,16165787,95
2987,3482569,1,24987620,24987791,24987705,171
2988,3482569,2,1926865,1926910,1926887,45
2989,3482569,3,8143809,8143880,8143844,71
2990,3482569,4,7486302,7486436,7486369,134
2991,3482570,1,25225443,25225683,25225563,240
2992,3482570,1,26515034,26517661,26516347,2627
2993,3482570,2,480373,480635,480504,262
2994,3482570,2,7607906,7609715,7608810,1809
2995,3482570,2,15902563,15903427,15902995,864
2996,3482570,3,17949753,17949966,17949859,213
2997,3482570,4,181484,182555,182019,1071
2998,3482570,4,16421452,16421669,16421560,217
2999,3482571,1,11215747,11215819,11215783,72
3000,3482571,1,12498837,12498910,12498873,73
3001,3482571,1,23351887,23352014,23351950,127
3002,3482571,1,27549275,27549606,27549440,331
3003,3482571,2,4962831,4962877,4962854,46
3004,3482571,3,8155177,8156257,8155717,1080
3005,3482571,3,21119744,21120393,21120068,649
3006,3482571,4,189438,189527,189482,89
3007,3482571,4,7939455,7939530,7939492,75
3008,3482571,5,326486,326945,326715,459
3009,3482571,5,9832569,9833145,9832857,576
3010,3482572,1,9811149,9811779,9811464,630
3011,3482572,1,17859595,17859705,17859650,110
3012,3482572,2,14203021,14203040,14203030,19
3013,3482572,2,16056977,16057135,16057056,158
3014,3482572,3,5495376,5497055,5496215,1679
3015,3482572,3,10952335,10952428,10952381,93
3016,3482572,3,20310054,20310466,20310260,412
3017,3482572,4,7653952,7653971,7653961,19
3018,3482572,4,11954093,11954504,11954298,411
3019,3482573,1,16124126,16124460,16124293,334
3020,3482573,1,25978216,25978976,25978596,760
3021,3482573,2,8177938,8178852,8178395,914
3022,3482573,3,9605751,9605969,9605860,218
3023,3482573,4,17995857,17998829,17997343,2972
3024,3482573,5,1076248,1076301,1076274,53
3025,3482573,5,21046023,21047144,21046583,1121
3026,3482574,1,7013137,7013154,7013145,17
3027,3482574,1,10256904,10257567,10257235,663
3028,3482574,1,28991360,28992542,28991951,1182
3029,3482574,2,9580578,9582009,9581293,1431
3030,3482574,3,5409713,5410560,5410136,847
3031,3482574,3,16648622,16648643,16648632,21
3032,3482574,3,23220601,23220853,23220727,252
3033,3482574,4,6320700,6320864,6320782,164
3034,3482574,4,16665950,16666056,16666003,106
3035,3482574,5,6832491,6834449,6833470,1958
3036,3482574,5,22866563,22866793,22866678,230
3037,3482575,1,2675138,2675512,2675325,374
3038,3482575,1,6855013,6855098,6855055,85
3039,3482575,1,17366364,17366640,17366502,276
3040,3482575,1,27319059,27319525,27319292,466
3041,3482575,2,15717723,15717866,15717794,143
3042,3482575,3,8544837,8546353,8545595,1516
3043,3482575,4,1284207,1284700,1284453,493
3044,3482575,4,17134914,17136308,17135611,1394
3045,3482575,5,16796926,16797001,16796963,75
3046,3482576,1,6679833,6680660,6680246,827
3047,3482576,1,11198685,11198687,11198686,2
3048,3482576,3,11759520,11759736,11759628,216
3049,3482576,4,173542,173598,173570,56
3050,3482576,4,10603128,10603176,10603152,48
3051,3482576,5,16595295,16596639,16595967,1344
3052,3482576,5,26248958,26249951,26249454,993
3053,3482577,1,1811231,1813474,1812352,2243
3054,3482577,1,17128424,17130123,17129273,1699
3055,3482577,1,23635430,23636046,23635738,616
3056,3482577,1,29184175,29185056,29184615,881
3057,3482577,2,13099699,13100840,13100269,1141
3058,3482577,2,16625449,16625528,16625488,79
3059,3482577,3,6046251,6046588,6046419,337
3060,3482577,3,9703582,9703625,9703603,43
3061,3482577,3,20588305,20588530,20588417,225
3062,3482577,3,22621709,22622533,22622121,824
3063,3482577,4,796862,796871,796866,9
3064,3482577,4,4873798,4874065,4873931,267
3065,3482577,5,324423,324461,324442,38
3066,3482577,5,16088350,16088405,16088377,55
3067,3482577,5,25823936,25824087,25824011,151
3068,3482578,1,1593255,1595475,1594365,2220
3069,3482578,1,3932938,3933012,3932975,74
3070,3482578,1,24790890,24790959,24790924,69
3071,3482578,1,28358802,28359873,28359337,1071
3072,3482578,3,1064461,1064688,1064574,227
3073,3482578,3,9864539,9864861,9864700,322
3074,3482578,4,65537,69362,67449,3825
3075,3482578,4,5292626,5294284,5293455,1658
3076,3482578,4,14448051,14448701,14448376,650
3077,3482579,2,296774,296799,296786,25
3078,3482579,2,5665889,5665944,5665916,55
3079,3482579,2,11820616,11820813,11820714,197
3080,3482579,3,7668507,7668731,7668619,224
3081,3482579,3,20690065,20690810,20690437,745
3082,3482579,4,10275945,10276114,10276029,169
3083,3482579,5,3516326,3517590,3516958,1264
3084,3482579,5,14707474,14707494,14707484,20
3085,3482579,5,26573967,26574121,26574044,154
3086,3482580,1,17769998,17771658,17770828,1660
3087,3482580,2,1926717,1926865,1926791,148
3088,3482580,2,14700872,14700978,14700925,106
3089,3482580,4,14226540,14226655,14226597,115
3090,3482580,5,3117050,3118080,3117565,1030
3091,3482580,5,9525195,9525537,9525366,342
3092,3482580,5,17805035,17805214,17805124,179
3093,3482581,1,7709960,7710983,7710471,1023
3094,3482581,1,17253798,17253829,17253813,31
3095,3482581,1,18362466,18362621,18362543,155
3096,3482581,1,26803898,26804018,26803958,120
3097,3482581,2,93778,94141,93959,363
3098,3482581,2,15507818,15508015,15507916,197
3099,3482581,3,11833638,11833746,11833692,108
3100,3482581,3,15931860,15931891,15931875,31
3101,3482581,4,5792905,5793003,5792954,98
3102,3482581,5,941518,941832,941675,314
3103,3482581,5,5026841,5027035,5026938,194
3104,3482581,5,16317108,16317210,16317159,102
3105,3482582,1,16266271,16266413,16266342,142
3106,3482582,1,26242706,26242887,26242796,181
3107,3482582,2,6505070,6505280,6505175,210
3108,3482582,3,2644494,2644625,2644559,131
3109,3482582,3,10336757,10336923,10336840,166
3110,3482582,4,5421763,5424464,5423113,2701
3111,3482582,4,10774261,10775043,10774652,782
3112,3482582,5,1110513,1111443,1110978,930
3113,3482582,5,17514248,17514282,17514265,34
3114,3482582,5,20920789,20920890,20920839,101
3115,3482583,1,24997663,24997836,24997749,173
3116,3482583,3,9970094,9971356,9970725,1262
3117,3482583,3,16150428,16151316,16150872,888
3118,3482583,4,148804,149783,149293,979
3119,3482583,5,5260200,5260284,5260242,84
3120,3482583,5,23838449,23838528,23838488,79
3121,3482584,2,475460,475938,475699,478
3122,3482584,2,9368421,9368673,9368547,252
3123,3482584,2,17380420,17380709,17380564,289
3124,3482584,2,18599987,18600340,18600163,353
3125,3482584,3,11104738,11105372,11105055,634
3126,3482584,4,8631093,8632026,8631559,933
3127,3482584,4,11118871,11121486,11120178,2615
3128,3482584,5,2938597,2940437,2939517,1840
3129,3482584,5,23226212,23226787,23226499,575
3130,3482584,5,26363279,26363318,26363298,39
3131,3482585,1,1702802,1703601,1703201,799
3132,3482585,1,12487527,12488202,12487864,675
3133,3482585,2,13744362,13744920,13744641,558
3134,3482585,3,9493320,9494117,9493718,797
3135,3482585,3,16629376,16629477,16629426,101
3136,3482585,4,5756665,5756748,5756706,83
3137,3482585,5,1523088,1523822,1523455,734
3138,3482585,5,2290856,2291729,2291292,873
3139,3482585,5,10386287,10386806,10386546,519
3140,3482589,1,17452558,17452580,17452569,22
3141,3482589,1,19090316,19090517,19090416,201
3142,3482589,1,28646998,28652550,28649774,5552
3143,3482589,2,12298889,12300124,12299506,1235
3144,3482589,3,8017521,8018088,8017804,567
3145,3482589,3,21342809,21342860,21342834,51
3146,3482589,4,11718995,11718999,11718997,4
3147,3482589,5,19970620,19970772,19970696,152
3148,3482590,1,8569385,8571907,8570646,2522
3149,3482590,2,6036066,6036484,6036275,418
3150,3482590,2,7830605,7831249,7830927,644
3151,3482590,2,13446101,13446107,13446104,6
3152,3482590,3,10896358,10896935,10896646,577
3153,3482590,5,17723600,17723775,17723687,175
3154,3482591,1,17171405,17171598,17171501,193
3155,3482591,1,28930867,28931540,28931203,673
3156,3482591,2,8941354,8941580,8941467,226
3157,3482591,4,802772,803063,802917,291
3158,3482591,4,18437485,18439230,18438357,1745
3159,3482591,5,3741179,3741261,3741220,82
3160,3482591,5,7767134,7768932,7768033,1798
3161,3482591,5,21484204,21484475,21484339,271
3162,3482592,1,6492483,6492710,6492596,227
3163,3482592,2,8099209,8104251,8101730,5042
3164,3482592,2,15544760,15544788,15544774,28
3165,3482592,3,10845819,10846116,10845967,297
3166,3482592,3,16929236,16930421,16929828,1185
3167,3482592,4,6751965,6752061,6752013,96
3168,3482592,5,3511762,3511790,3511776,28
3169,3482592,5,5723886,5724689,5724287,803
3170,3482593,2,6811716,6811809,6811762,93
3171,3482593,2,9711843,9713148,9712495,1305
3172,3482593,3,4451041,4452589,4451815,1548
3173,3482593,4,18072883,18075418,18074150,2535
3174,3482593,5,6061905,6062476,6062190,571
3175,3482593,5,13900991,13901168,13901079,177
3176,3482593,5,22027041,22028122,22027581,1081
3177,3482594,3,14940751,14940974,14940862,223
3178,3482594,3,16618206,16618791,16618498,585
3179,3482594,4,7604690,7604702,7604696,12
3180,3482594,5,3312929,3313037,3312983,108
3181,3482594,5,24541674,24541688,24541681,14
3182,3482595,1,4795789,4795948,4795868,159
3183,3482595,1,7636017,7636148,7636082,131
3184,3482595,1,18434721,18434886,18434803,165
3185,3482595,1,25025411,25025482,25025446,71
3186,3482595,2,15141949,15143739,15142844,1790
3187,3482595,3,8980740,8980818,8980779,78
3188,3482595,3,10947549,10949969,10948759,2420
3189,3482595,4,11893282,11894735,11894008,1453
3190,3482595,5,7174668,7174881,7174774,213
3191,3482595,5,13614971,13615549,13615260,578
3192,3482595,5,18780883,18781202,18781042,319
3193,3482596,1,17380108,17380159,17380133,51
3194,3482596,2,2294527,2294726,2294626,199
3195,3482596,3,17941022,17941208,17941115,186
3196,3482596,4,8831218,8831411,8831314,193
3197,3482596,4,10753232,10753481,10753356,249
3198,3482596,5,4900062,4900514,4900288,452
3199,3482596,5,18158658,18158744,18158701,86
3200,3482596,5,21365903,21366359,21366131,456
3201,3482597,1,7793158,7793609,7793383,451
3202,3482597,1,18558518,18559365,18558941,847
3203,3482597,1,26633941,26633988,26633964,47
3204,3482597,1,29445670,29445754,29445712,84
3205,3482597,2,6293976,6294137,6294056,161
3206,3482597,2,16313721,16314358,16314039,637
3207,3482597,3,15985269,15985760,15985514,491
3208,3482597,3,17899029,17899107,17899068,78
3209,3482597,4,10887237,10887893,10887565,656
3210,3482597,5,25983066,25983404,25983235,338
3211,3482598,1,8339797,8340499,8340148,702
3212,3482598,2,6275604,6276427,6276015,823
3213,3482598,3,8011402,8011716,8011559,314
3214,3482598,3,8011716,8012099,8011907,383
3215,3482598,4,6102164,6103354,6102759,1190
3216,3482598,4,7614501,7614538,7614519,37
3217,3482598,5,1010342,1010791,1010566,449
3218,3482599,1,8877921,8879175,8878548,1254
3219,3482599,2,7259494,7260605,7260049,1111
3220,3482599,3,4103823,4104305,4104064,482
3221,3482599,3,17477696,17478713,17478204,1017
3222,3482599,4,1207666,1207780,1207723,114
3223,3482599,4,14013493,14014051,14013772,558
3224,3482599,5,16571877,16571997,16571937,120
3225,3482599,5,26383307,26384051,26383679,744
3226,3482600,1,2880800,2882273,2881536,1473
3227,3482600,2,6916378,6916417,6916397,39
3228,3482600,2,15097997,15098054,15098025,57
3229,3482600,3,10032980,10034558,10033769,1578
3230,3482600,4,6827251,6827309,6827280,58
3231,3482600,5,976554,976950,976752,396
3232,3482600,5,15463501,15464962,15464231,1461
3233,3482600,5,21648945,21651201,21650073,2256
3234,3482604,1,7405712,7405793,7405752,81
3235,3482604,1,17955008,17955625,17955316,617
3236,3482604,1,28905276,28905429,28905352,153
3237,3482604,2,14906303,14907590,14906946,1287
3238,3482604,3,9327008,9327299,9327153,291
3239,3482604,3,22111099,22111227,22111163,128
3240,3482604,4,8197042,8197686,8197364,644
3241,3482604,5,8591036,8591175,8591105,139
3242,3482604,5,21671448,21672413,21671930,965
3243,3482605,1,5288725,5289014,5288869,289
3244,3482605,1,12740937,12741051,12740994,114
3245,3482605,1,23792959,23793336,23793147,377
3246,3482605,2,19010975,19013031,19012003,2056
3247,3482605,3,23045862,23045990,23045926,128
3248,3482605,4,17802468,17802898,17802683,430
3249,3482605,5,434770,435338,435054,568
3250,3482605,5,23913752,23914002,23913877,250
3251,3482606,1,24139563,24144345,24141954,4782
3252,3482606,2,1711317,1714040,1712678,2723
3253,3482606,2,16103560,16104333,16103946,773
3254,3482606,3,8842064,8842159,8842111,95
3255,3482606,3,23243840,23244824,23244332,984
3256,3482606,4,6856232,6856731,6856481,499
3257,3482606,5,18753464,18753711,18753587,247
3258,3482607,1,3496638,3499224,3497931,2586
3259,3482607,1,10036829,10038527,10037678,1698
3260,3482607,1,24397935,24401009,24399472,3074
3261,3482607,2,6520974,6523104,6522039,2130
3262,3482607,2,12943709,12944376,12944042,667
3263,3482607,2,19021871,19022934,19022402,1063
3264,3482607,4,11702668,11703141,11702904,473
3265,3482607,4,18304909,18304921,18304915,12
3266,3482607,5,1258096,1258355,1258225,259
3267,3482607,5,5275064,5275936,5275500,872
3268,3482607,5,18045887,18045942,18045914,55
3269,3482608,1,16379670,16379704,16379687,34
3270,3482608,1,17705586,17705777,17705681,191
3271,3482608,2,6501890,6501932,6501911,42
3272,3482608,3,16648622,16648643,16648632,21
3273,3482608,4,1563163,1563493,1563328,330
3274,3482608,4,10106140,10106324,10106232,184
3275,3482608,4,15225364,15225991,15225677,627
3276,3482608,5,1138423,1139407,1138915,984
3277,3482608,5,5375701,5377605,5376653,1904
3278,3482609,1,8586302,8586951,8586626,649
3279,3482609,1,28001119,28005959,28003539,4840
3280,3482609,2,6831190,6831885,6831537,695
3281,3482609,2,14435608,14435885,14435746,277
3282,3482609,2,16232121,16235244,16233682,3123
3283,3482609,3,6677897,6678191,6678044,294
3284,3482609,3,22928971,22929019,22928995,48
3285,3482609,4,10962153,10962256,10962204,103
3286,3482609,5,4609668,4611344,4610506,1676
3287,3482609,5,21532834,21532888,21532861,54
3288,3482610,1,11629198,11629513,11629355,315
3289,3482610,2,225899,227341,226620,1442
3290,3482610,2,19582502,19582660,19582581,158
3291,3482610,3,8555529,8555565,8555547,36
3292,3482610,3,11277527,11280787,11279157,3260
3293,3482610,4,1602504,1602515,1602509,11
3294,3482610,4,8176595,8176695,8176645,100
3295,3482610,4,17372275,17373869,17373072,1594
3296,3482610,5,2214630,2216065,2215347,1435
3297,3482610,5,15920618,15920636,15920627,18
3298,3482610,5,24216252,24217677,24216964,1425
3299,3482611,1,11463028,11463408,11463218,380
3300,3482611,1,23136890,23137013,23136951,123
3301,3482611,2,513879,514173,514026,294
3302,3482611,2,6655017,6655103,6655060,86
3303,3482611,3,17690587,17690671,17690629,84
3304,3482611,3,22606049,22607727,22606888,1678
3305,3482611,4,550692,551982,551337,1290
3306,3482611,4,576923,577526,577224,603
3307,3482611,4,13038096,13038235,13038165,139
3308,3482611,5,8629773,8630028,8629900,255
3309,3482611,5,8994196,8994218,8994207,22
3310,3482611,5,21169250,21170416,21169833,1166
3311,3482612,1,4210885,4211085,4210985,200
3312,3482612,2,2089817,2089837,2089827,20
3313,3482612,2,2202932,2203045,2202988,113
3314,3482612,2,19558667,19559640,19559153,973
3315,3482612,3,3665560,3666727,3666143,1167
3316,3482612,3,9679819,9680282,9680050,463
3317,3482612,5,7222153,7222844,7222498,691
3318,3482612,5,14656080,14656276,14656178,196
3319,3482612,5,22174141,22174708,22174424,567
3320,3482612,5,25823743,25823911,25823827,168
3321,3482613,1,2833678,2834256,2833967,578
3322,3482613,1,11937526,11937569,11937547,43
3323,3482613,1,25301022,25301402,25301212,380
3324,3482613,2,1182606,1182817,1182711,211
3325,3482613,2,14575482,14577159,14576320,1677
3326,3482613,2,17123157,17125017,17124087,1860
3327,3482613,3,8972750,8972851,8972800,101
3328,3482613,4,13496852,13497220,13497036,368
3329,3482613,4,17524318,17524337,17524327,19
3330,3482613,5,14187263,14188673,14187968,1410
3331,3482613,5,15752998,15754150,15753574,1152
3332,3482614,1,6790271,6790420,6790345,149
3333,3482614,1,19522620,19522689,19522654,69
3334,3482614,2,688762,688818,688790,56
3335,3482614,2,9953242,9953420,9953331,178
3336,3482614,3,1487098,1487284,1487191,186
3337,3482614,3,16691049,16702306,16696677,11257
3338,3482614,4,5464513,5464795,5464654,282
3339,3482614,4,11768123,11768307,11768215,184
3340,3482614,5,4204421,4204503,4204462,82
3341,3482614,5,5997335,5997947,5997641,612
3342,3482615,1,9888445,9889003,9888724,558
3343,3482615,1,23421505,23421763,23421634,258
3344,3482615,1,24710678,24710873,24710775,195
3345,3482615,2,2099879,2100144,2100011,265
3346,3482615,3,5060615,5061066,5060840,451
3347,3482615,3,15408634,15408901,15408767,267
3348,3482615,4,8502843,8503753,8503298,910
3349,3482616,1,12561052,12561485,12561268,433
3350,3482616,1,28416119,28416509,28416314,390
3351,3482616,1,29512831,29512949,29512890,118
3352,3482616,2,10053065,10053286,10053175,221
3353,3482616,3,16921035,16921479,16921257,444
3354,3482616,5,733232,733600,733416,368
3355,3482616,5,14067592,14068970,14068281,1378
3356,3482616,5,25346481,25347423,25346952,942
3357,3482617,1,1822101,1822139,1822120,38
3358,3482617,1,11262826,11262981,11262903,155
3359,3482617,2,6666048,6666107,6666077,59
3360,3482617,3,8174821,8174917,8174869,96
3361,3482617,4,466064,466189,466126,125
3362,3482617,4,9744268,9745120,9744694,852
3363,3482617,5,1550690,1551050,1550870,360
3364,3482617,5,19731167,19731385,19731276,218
3365,3482617,5,26079174,26079404,26079289,230
3366,3482618,1,7236769,7237396,7237082,627
3367,3482618,2,10502537,10503662,10503099,1125
3368,3482618,2,15890621,15891216,15890918,595
3369,3482618,3,22362499,22363529,22363014,1030
3370,3482618,4,17392147,17392530,17392338,383
3371,3482618,5,20539421,20539475,20539448,54
3372,3482619,1,569204,569241,569222,37
3373,3482619,1,17913647,17913798,17913722,151
3374,3482619,1,27157422,27158437,27157929,1015
3375,3482619,2,4824053,4824116,4824084,63
3376,3482619,2,5768705,5769264,5768984,559
3377,3482619,2,18602383,18603110,18602746,727
3378,3482619,4,16321995,16322063,16322029,68
3379,3482619,5,22861947,22861956,22861951,9
3380,3482620,1,10487895,10487984,10487939,89
3381,3482620,2,5644430,5644673,5644551,243
3382,3482620,3,9383778,9387166,9385472,3388
3383,3482620,4,5165967,5168555,5167261,2588
3384,3482620,4,7021741,7021803,7021772,62
3385,3482620,5,5937475,5937512,5937493,37
3386,3482620,5,9572143,9572687,9572415,544
3387,3482620,5,18138635,18138813,18138724,178
3388,3482621,1,6686957,6687079,6687018,122
3389,3482621,1,26214443,26215506,26214974,1063
3390,3482621,2,14285188,14285805,14285496,617
3391,3482621,3,1097130,1097137,1097133,7
3392,3482621,3,11049208,11049312,11049260,104
3393,3482621,3,21231015,21231141,21231078,126
3394,3482621,5,7981324,7981997,7981660,673
3395,3482621,5,8681274,8682275,8681774,1001
3396,3482622,1,429044,432021,430532,2977
3397,3482622,1,12694483,12695071,12694777,588
3398,3482622,1,24849673,24849922,24849797,249
3399,3482622,3,10518982,10519124,10519053,142
3400,3482622,5,9970326,9972097,9971211,1771
3401,3482622,5,15375024,15375366,15375195,342
3402,3482622,5,25108622,25108836,25108729,214
3403,3482623,1,8111238,8111295,8111266,57
3404,3482623,2,15375613,15378644,15377128,3031
3405,3482623,3,4063975,4064382,4064178,407
3406,3482623,3,17163446,17163541,17163493,95
3407,3482623,4,367430,367468,367449,38
3408,3482623,5,16149621,16149743,16149682,122
3409,3482624,2,221790,222306,222048,516
3410,3482624,2,17671229,17671650,17671439,421
3411,3482624,5,880193,880282,880237,89
3412,3482624,5,3384093,3384998,3384545,905
3413,3482624,5,16876348,16876688,16876518,340
3414,3482624,5,25511487,25511519,25511503,32
3415,3482625,2,370481,373365,371923,2884
3416,3482625,2,18993639,18994907,18994273,1268
3417,3482625,3,323623,324242,323932,619
3418,3482625,3,6269623,6270498,6270060,875
3419,3482625,3,20661935,20663408,20662671,1473
3420,3482625,5,3505905,3506135,3506020,230
3421,3482625,5,16594401,16594775,16594588,374
3422,3482626,1,13468281,13468902,13468591,621
3423,3482626,1,29644546,29645697,29645121,1151
3424,3482626,2,7609715,7610736,7610225,1021
3425,3482626,3,9038046,9038311,9038178,265
3426,3482626,4,11354932,11355541,11355236,609
3427,3482627,2,6214560,6215132,6214846,572
3428,3482627,2,10562284,10562292,10562288,8
3429,3482627,3,7824749,7825047,7824898,298
3430,3482627,3,10877554,10879224,10878389,1670
3431,3482627,5,25090082,25090152,25090117,70
3432,3482628,1,8199854,8200339,8200096,485
3433,3482628,1,28562347,28564530,28563438,2183
3434,3482628,2,6880020,6880212,6880116,192
3435,3482628,3,16482843,16482977,16482910,134
3436,3482628,3,19231042,19231180,19231111,138
3437,3482628,4,7620619,7620687,7620653,68
3438,3482628,4,13217351,13217586,13217468,235
3439,3482628,5,4983121,4983416,4983268,295
3440,3482629,1,26718702,26720882,26719792,2180
3441,3482629,2,11116090,11117618,11116854,1528
3442,3482629,2,17570596,17570959,17570777,363
3443,3482629,3,10351667,10352062,10351864,395
3444,3482629,4,5367784,5368132,5367958,348
3445,3482629,5,20894213,20894411,20894312,198
3446,3482629,5,26623040,26623061,26623050,21
3447,3482630,1,6267276,6269073,6268174,1797
3448,3482630,1,22070910,22071064,22070987,154
3449,3482630,1,26249846,26249900,26249873,54
3450,3482630,2,14283812,14284584,14284198,772
3451,3482630,2,18961223,18961510,18961366,287
3452,3482630,5,9143285,9143306,9143295,21
3453,3482630,5,13879344,13879478,13879411,134
3454,3482630,5,19858559,19861267,19859913,2708
3455,3482631,1,17252628,17253368,17252998,740
3456,3482631,1,24846283,24849532,24847907,3249
3457,3482631,2,842546,843531,843038,985
3458,3482631,2,1523708,1529200,1526454,5492
3459,3482631,3,9341033,9341072,9341052,39
3460,3482631,3,15605602,15606042,15605822,440
3461,3482631,4,16884792,16885547,16885169,755
3462,3482631,5,4320474,4326814,4323644,6340
3463,3482631,5,22350919,22351187,22351053,268
3464,3482631,5,22921572,22924078,22922825,2506
3465,3482632,1,10994275,10994916,10994595,641
3466,3482632,1,27448037,27448739,27448388,702
3467,3482632,3,15656893,15657365,15657129,472
3468,3482632,5,6831050,6831253,6831151,203
3469,3482633,1,6317831,6318268,6318049,437
3470,3482633,1,7731429,7731453,7731441,24
3471,3482633,1,11953620,11954853,11954236,1233
3472,3482633,3,5921517,5923973,5922745,2456
3473,3482633,3,18397468,18397660,18397564,192
3474,3482633,5,8189440,8193756,8191598,4316
3475,3482634,1,3839791,3840429,3840110,638
3476,3482634,1,17229846,17230891,17230368,1045
3477,3482634,1,26222731,26223010,26222870,279
3478,3482634,2,13904897,13905332,13905114,435
3479,3482634,2,16498205,16498490,16498347,285
3480,3482634,3,11074551,11074602,11074576,51
3481,3482634,4,5709729,5710119,5709924,390
3482,3482634,4,16699056,16699209,16699132,153
3483,3482634,5,15664215,15695771,15679993,31556
3484,3482635,1,2284311,2284734,2284522,423
3485,3482635,1,23479827,23480184,23480005,357
3486,3482635,1,24655978,24656351,24656164,373
3487,3482635,2,10743512,10743536,10743524,24
3488,3482635,2,16539734,16539806,16539770,72
3489,3482635,3,8478364,8480295,8479329,1931
3490,3482635,3,18142585,18142786,18142685,201
3491,3482635,5,10831129,10831369,10831249,240
3492,3482635,5,13612102,13612258,13612180,156
3493,3482636,1,7773942,7780266,7777104,6324
3494,3482636,1,26100828,26100913,26100870,85
3495,3482636,2,1179951,1181523,1180737,1572
3496,3482636,2,16419147,16419279,16419213,132
3497,3482636,3,15538338,15538638,15538488,300
3498,3482636,3,15994796,15994938,15994867,142
3499,3482636,5,1603774,1604221,1603997,447
3500,3482636,5,3480801,3481638,3481219,837
3501,3482636,5,14727698,14728789,14728243,1091
3502,3482637,1,3209636,3209670,3209653,34
3503,3482637,1,10601544,10602503,10602023,959
3504,3482637,1,25936859,25937433,25937146,574
3505,3482637,3,20546528,20548501,20547514,1973
3506,3482637,4,18309600,18310259,18309929,659
3507,3482637,5,9227679,9230522,9229100,2843
3508,3482637,5,26058209,26059221,26058715,1012
3509,3482638,1,2755307,2755961,2755634,654
3510,3482638,1,18388169,18388266,18388217,97
3511,3482638,1,28883552,28885946,28884749,2394
3512,3482638,2,4823618,4824053,4823835,435
3513,3482638,2,12175056,12175195,12175125,139
3514,3482638,2,12846321,12846391,12846356,70
3515,3482638,4,7633166,7633914,7633540,748
3516,3482638,4,17577737,17577886,17577811,149
3517,3482638,5,10268208,10268312,10268260,104
3518,3482638,5,25333305,25333443,25333374,138
3519,3482639,1,6492774,6492874,6492824,100
3520,3482639,1,23244195,23244460,23244327,265
3521,3482639,2,9556669,9556961,9556815,292
3522,3482639,3,15910673,15911104,15910888,431
3523,3482639,4,5700794,5700959,5700876,165
3524,3482639,5,13870297,13875080,13872688,4783
3525,3482639,5,15760924,15762639,15761781,1715
3526,3482640,1,17367033,17367241,17367137,208
3527,3482640,1,22268677,22269654,22269165,977
3528,3482640,2,9214969,9215342,9215155,373
3529,3482640,2,11339539,11339690,11339614,151
3530,3482640,3,1349519,1349736,1349627,217
3531,3482640,4,6253994,6254448,6254221,454
3532,3482640,4,9926386,9926430,9926408,44
3533,3482640,5,1453569,1453741,1453655,172
3534,3482640,5,18074660,18075337,18074998,677
3535,3482641,1,1550920,1553574,1552247,2654
3536,3482641,1,18247706,18251098,18249402,3392
3537,3482641,1,25025160,25025254,25025207,94
3538,3482641,2,7880942,7881001,7880971,59
3539,3482641,3,8966386,8966467,8966426,81
3540,3482641,4,8910739,8910806,8910772,67
3541,3482641,5,16305965,16307242,16306603,1277
3542,3482641,5,23061116,23061267,23061191,151
3543,3482641,5,25672709,25674633,25673671,1924
3544,3482642,1,17508827,17509025,17508926,198
3545,3482642,1,30193238,30194392,30193815,1154
3546,3482642,2,9686367,9688510,9687438,2143
3547,3482642,2,10382341,10382763,10382552,422
3548,3482642,3,6631727,6639255,6635491,7528
3549,3482642,3,22709307,22709893,22709600,586
3550,3482642,4,12860195,12860840,12860517,645
3551,3482642,5,13654605,13654634,13654619,29
3552,3482643,1,10979724,10979727,10979725,3
3553,3482643,1,26475098,26475765,26475431,667
3554,3482643,2,6928892,6930201,6929546,1309
3555,3482643,3,110693,112015,111354,1322
3556,3482643,3,17610150,17610475,17610312,325
3557,3482643,4,7755336,7755410,7755373,74
3558,3482643,5,18698890,18699286,18699088,396
3559,3482643,5,21327484,21327881,21327682,397
3560,3482644,1,8178679,8178740,8178709,61
3561,3482644,1,23699291,23699392,23699341,101
3562,3482644,1,25830711,25831057,25830884,346
3563,3482644,2,204042,204126,204084,84
3564,3482644,3,9716110,9718105,9717107,1995
3565,3482644,4,5701150,5702450,5701800,1300
3566,3482644,5,6878108,6878862,6878485,754
3567,3482644,5,14954555,14954557,14954556,2
3568,3482644,5,26618607,26619357,26618982,750
3569,3482645,1,4525590,4526278,4525934,688
3570,3482645,1,17366710,17366744,17366727,34
3571,3482645,1,29274054,29274583,29274318,529
3572,3482645,2,11193326,11193357,11193341,31
3573,3482645,2,12262891,12263658,12263274,767
3574,3482645,5,13774109,13776333,13775221,2224
3575,3482646,1,4267957,4269017,4268487,1060
3576,3482646,1,6108593,6108621,6108607,28
3577,3482646,1,23654721,23655453,23655087,732
3578,3482646,1,26684976,26685700,26685338,724
3579,3482646,2,15425844,15426316,15426080,472
3580,3482646,3,9955517,9958128,9956822,2611
3581,3482646,3,16141239,16145067,16143153,3828
3582,3482646,3,22461810,22462380,22462095,570
3583,3482646,4,8900391,8900487,8900439,96
3584,3482646,5,4614721,4618578,4616649,3857
3585,3482646,5,22077982,22079616,22078799,1634
3586,3482647,1,16872221,16872461,16872341,240
3587,3482647,1,20146194,20152275,20149234,6081
3588,3482647,1,25935935,25936114,25936024,179
3589,3482647,1,26354357,26354468,26354412,111
3590,3482647,2,9762114,9762294,9762204,180
3591,3482647,2,17494583,17494615,17494599,32
3592,3482647,3,19626549,19626874,19626711,325
3593,3482647,4,5143504,5143632,5143568,128
3594,3482647,5,5306254,5307508,5306881,1254
3595,3482647,5,9914527,9917422,9915974,2895
3596,3482647,5,16741374,16741607,16741490,233
3597,3482647,5,25884501,25884567,25884534,66
3598,3482648,2,12130567,12131937,12131252,1370
3599,3482648,2,17416344,17417291,17416817,947
3600,3482648,3,10802316,10802347,10802331,31
3601,3482648,3,12100842,12100886,12100864,44
3602,3482648,4,436117,436129,436123,12
3603,3482648,4,8606223,8608007,8607115,1784
3604,3482649,1,8061065,8061835,8061450,770
3605,3482649,1,28587867,28589606,28588736,1739
3606,3482649,1,29765363,29765726,29765544,363
3607,3482649,3,8929785,8930056,8929920,271
3608,3482649,3,10189784,10189866,10189825,82
3609,3482649,4,14559212,14559312,14559262,100
3610,3482649,4,18161698,18162117,18161907,419
3611,3482649,5,15871676,15873226,15872451,1550
3612,3482649,5,18374561,18375298,18374929,737
3613,3482653,2,6304966,6305457,6305211,491
3614,3482653,2,10755041,10755077,10755059,36
3615,3482653,3,8808050,8808110,8808080,60
3616,3482653,3,15358109,15358499,15358304,390
3617,3482653,5,1137795,1137810,1137802,15
3618,3482653,5,16668709,16668772,16668740,63
3619,3482654,1,16416807,16417475,16417141,668
3620,3482654,1,26585390,26586874,26586132,1484
3621,3482654,1,30416501,30416591,30416546,90
3622,3482654,2,664291,664329,664310,38
3623,3482654,2,10606156,10606894,10606525,738
3624,3482654,3,11282208,11282418,11282313,210
3625,3482654,4,5737587,5738724,5738155,1137
3626,3482654,5,25893521,25895119,25894320,1598
3627,3482655,1,26803191,26803898,26803544,707
3628,3482655,2,475938,477263,476600,1325
3629,3482655,2,12619865,12619944,12619904,79
3630,3482655,3,7824749,7825049,7824899,300
3631,3482655,3,9713634,9713782,9713708,148
3632,3482655,4,15687993,15688224,15688108,231
3633,3482655,5,14958789,14959720,14959254,931
3634,3482656,1,19516568,19516602,19516585,34
3635,3482656,2,7719883,7720078,7719980,195
3636,3482656,3,11154685,11154811,11154748,126
3637,3482656,3,18787684,18787772,18787728,88
3638,3482656,3,20589764,20590526,20590145,762
3639,3482656,4,6424545,6426033,6425289,1488
3640,3482656,5,5146490,5147264,5146877,774
3641,3482656,5,10821755,10821841,10821798,86
3642,3482657,1,11388241,11388279,11388260,38
3643,3482657,1,21903298,21903468,21903383,170
3644,3482657,2,7816173,7816815,7816494,642
3645,3482657,2,18849092,18849338,18849215,246
3646,3482657,3,1712344,1712394,1712369,50
3647,3482657,3,17913977,17914851,17914414,874
3648,3482658,1,636788,636917,636852,129
3649,3482658,1,25698933,25702694,25700813,3761
3650,3482658,2,12367974,12368758,12368366,784
3651,3482658,3,1690207,1690250,1690228,43
3652,3482658,3,10388831,10389360,10389095,529
3653,3482658,5,8269142,8270165,8269653,1023
3654,3482658,5,9269975,9270461,9270218,486
3655,3482659,1,369925,371972,370948,2047
3656,3482659,1,9842275,9842404,9842339,129
3657,3482659,1,17281961,17283163,17282562,1202
3658,3482659,1,18182478,18182647,18182562,169
3659,3482659,1,28549869,28550120,28549994,251
3660,3482659,2,18359109,18360635,18359872,1526
3661,3482659,3,261113,261976,261544,863
3662,3482659,3,17603721,17603752,17603736,31
3663,3482659,4,6540873,6542479,6541676,1606
3664,3482659,4,7366291,7366392,7366341,101
3665,3482659,5,7269200,7269856,7269528,656
3666,3482659,5,22091566,22092370,22091968,804
3667,3482659,5,26805767,26805810,26805788,43
3668,3482660,3,14944658,14944975,14944816,317
3669,3482660,4,8308353,8308538,8308445,185
3670,3482660,5,9054873,9054936,9054904,63
3671,3482660,5,23782332,23782453,23782392,121
3672,3482661,1,9452490,9453431,9452960,941
3673,3482661,1,30036307,30036412,30036359,105
3674,3482661,3,6492973,6493214,6493093,241
3675,3482661,4,280328,280777,280552,449
3676,3482661,4,8386992,8387166,8387079,174
3677,3482661,4,17466348,17467919,17467133,1571
3678,3482661,5,7177847,7178907,7178377,1060
3679,3482662,1,7659301,7659914,7659607,613
3680,3482662,1,22795183,22795229,22795206,46
3681,3482662,1,23258035,23258340,23258187,305
3682,3482662,2,809661,810356,810008,695
3683,3482662,3,11112528,11112795,11112661,267
3684,3482662,4,11858757,11859519,11859138,762
3685,3482663,1,11353249,11353430,11353339,181
3686,3482663,1,17001377,17001449,17001413,72
3687,3482663,1,18240108,18241123,18240615,1015
3688,3482663,1,26862435,26862558,26862496,123
3689,3482663,1,30397107,30397395,30397251,288
3690,3482663,2,12294172,12294640,12294406,468
3691,3482663,4,11529974,11530674,11530324,700
3692,3482663,5,541756,544105,542930,2349
3693,3482663,5,4199250,4199254,4199252,4
3694,3482663,5,16214336,16214590,16214463,254
3695,3482663,5,26271486,26271858,26271672,372
3696,3482664,1,19915046,19915315,19915180,269
3697,3482664,1,27145576,27148382,27146979,2806
3698,3482664,2,6241575,6242269,6241922,694
3699,3482664,2,18957825,18958146,18957985,321
3700,3482664,3,3350888,3351064,3350976,176
3701,3482664,3,7384764,7385464,7385114,700
3702,3482664,3,8550927,8550963,8550945,36
3703,3482664,3,18363157,18363255,18363206,98
3704,3482664,4,10103141,10104499,10103820,1358
3705,3482664,5,17876836,17877887,17877361,1051
3706,3482664,5,21729791,21730554,21730172,763
3707,3482665,1,17859705,17859914,17859809,209
3708,3482665,1,21378792,21378862,21378827,70
3709,3482665,1,28401225,28401500,28401362,275
3710,3482665,2,144378,144787,144582,409
3711,3482665,3,17385513,17385854,17385683,341
3712,3482665,3,18450273,18451993,18451133,1720
3713,3482665,4,919317,919392,919354,75
3714,3482665,5,10276322,10277556,10276939,1234
3715,3482666,1,9196886,9197577,9197231,691
3716,3482666,1,12685973,12686060,12686016,87
3717,3482666,1,19855828,19856239,19856033,411
3718,3482666,1,27151193,27151412,27151302,219
3719,3482666,2,8059771,8059998,8059884,227
3720,3482666,4,244781,244787,244784,6
3721,3482667,1,12573537,12573874,12573705,337
3722,3482667,1,28580904,28581057,28580980,153
3723,3482667,3,9003616,9003841,9003728,225
3724,3482667,3,10689900,10690098,10689999,198
3725,3482667,4,7001295,7001639,7001467,344
3726,3482667,5,8539541,8539737,8539639,196
3727,3482667,5,10288635,10290254,10289444,1619
3728,3482668,1,25008212,25008370,25008291,158
3729,3482668,2,7245403,7245625,7245514,222
3730,3482668,3,11302285,11302662,11302473,377
3731,3482668,3,17198388,17198505,17198446,117
3732,3482668,5,2416732,2417586,2417159,854
3733,3482668,5,14993717,14993774,14993745,57
3734,3482669,1,16233116,16233207,16233161,91
3735,3482669,3,21536692,21536721,21536706,29
3736,3482669,4,403192,403483,403337,291
3737,3482669,4,14795569,14795591,14795580,22
3738,3482669,5,9887959,9888008,9887983,49
3739,3482669,5,25999166,26001022,26000094,1856
3740,3482670,1,24753451,24753491,24753471,40
3741,3482670,1,28314640,28315680,28315160,1040
3742,3482670,2,6368589,6368774,6368681,185
3743,3482670,2,17987205,17987271,17987238,66
3744,3482670,2,18676024,18676192,18676108,168
3745,3482670,3,18426838,18427164,18427001,326
3746,3482670,4,5277049,5277125,5277087,76
3747,3482670,5,7287773,7291802,7289787,4029
3748,3482670,5,19212487,19213495,19212991,1008
3749,3482671,1,10620148,10621738,10620943,1590
3750,3482671,1,17385369,17386168,17385768,799
3751,3482671,1,24644749,24644961,24644855,212
3752,3482671,1,30282021,30282102,30282061,81
3753,3482671,2,12915368,12919307,12917337,3939
3754,3482671,2,15049831,15050160,15049995,329
3755,3482671,3,1486628,1486983,1486805,355
3756,3482671,5,1571442,1572289,1571865,847
3757,3482672,1,8352522,8352744,8352633,222
3758,3482672,1,21864413,21865185,21864799,772
3759,3482672,3,1130420,1130936,1130678,516
3760,3482672,3,9860455,9861003,9860729,548
3761,3482672,4,9325473,9329006,9327239,3533
3762,3482672,5,14527697,14527757,14527727,60
3763,3482673,1,13276156,13276176,13276166,20
3764,3482673,1,20161657,20161797,20161727,140
3765,3482673,3,1067238,1067376,1067307,138
3766,3482673,4,4939998,4940113,4940055,115
3767,3482673,4,17849597,17850934,17850265,1337
3768,3482673,5,18906697,18906768,18906732,71
3769,3482677,4,623181,624344,623762,1163
3770,3482677,4,5711913,5712279,5712096,366
3771,3482677,5,775710,775743,775726,33
3772,3482677,5,8194916,8196000,8195458,1084
3773,3482677,5,23113582,23113610,23113596,28
3774,3482678,1,4193399,4193422,4193410,23
3775,3482678,1,8404954,8406407,8405680,1453
3776,3482678,1,19334016,19334300,19334158,284
3777,3482678,3,12273218,12273478,12273348,260
3778,3482678,4,281126,283724,282425,2598
3779,3482678,4,7947025,7947543,7947284,518
3780,3482678,4,18034678,18034751,18034714,73
3781,3482678,5,6412204,6413015,6412609,811
3782,3482679,1,4287037,4289556,4288296,2519
3783,3482679,2,11979193,11979472,11979332,279
3784,3482679,3,22816728,22816908,22816818,180
3785,3482679,4,10713555,10714555,10714055,1000
3786,3482679,5,466594,466705,466649,111
3787,3482679,5,18576693,18576957,18576825,264
3788,3482679,5,22662476,22665793,22664134,3317
3789,3482682,1,13146997,13147059,13147028,62
3790,3482682,1,19151372,19151620,19151496,248
3791,3482682,1,20930313,20930364,20930338,51
3792,3482682,2,2302137,2302307,2302222,170
3793,3482682,2,9746398,9746711,9746554,313
3794,3482682,3,9459360,9459511,9459435,151
3795,3482682,3,10798574,10799036,10798805,462
3796,3482682,4,11662986,11664113,11663549,1127
3797,3482682,4,18403398,18404128,18403763,730
3798,3482682,5,8562328,8562502,8562415,174
3799,3482682,5,10780824,10783157,10781990,2333
3800,3482683,1,8533147,8533432,8533289,285
3801,3482683,1,25734913,25735095,25735004,182
3802,3482683,1,28984748,28985983,28985365,1235
3803,3482683,2,12216318,12216653,12216485,335
3804,3482683,3,9921788,9922819,9922303,1031
3805,3482683,3,21186653,21186973,21186813,320
3806,3482683,4,130310,131413,130861,1103
3807,3482683,4,1039080,1039170,1039125,90
3808,3482683,5,5280317,5281890,5281103,1573
3809,3482684,1,1867912,1868783,1868347,871
3810,3482684,1,2900333,2901321,2900827,988
3811,3482684,1,26360648,26361348,26360998,700
3812,3482684,3,16615311,16616415,16615863,1104
3813,3482684,4,82672,83940,83306,1268
3814,3482684,5,8846258,8846590,8846424,332
3815,3482685,1,12201915,12202259,12202087,344
3816,3482685,1,17171618,17171964,17171791,346
3817,3482685,1,26248555,26248619,26248587,64
3818,3482685,2,8091049,8091099,8091074,50
3819,3482685,2,16999503,17000589,17000046,1086
3820,3482685,3,15185880,15186071,15185975,191
3821,3482685,4,221564,221625,221594,61
3822,3482685,4,1585585,1585658,1585621,73
3823,3482685,5,18184252,18184577,18184414,325
3824,3482686,1,8017684,8018040,8017862,356
3825,3482686,1,28304294,28305029,28304661,735
3826,3482686,2,16164119,16164406,16164262,287
3827,3482686,3,15752446,15752447,15752446,1
3828,3482686,4,11518099,11519707,11518903,1608
3829,3482686,5,16825752,16825805,16825778,53
3830,3482687,1,15985772,15986009,15985890,237
3831,3482687,1,29782748,29782787,29782767,39
3832,3482687,2,9322334,9322426,9322380,92
3833,3482687,2,16306592,16307064,16306828,472
3834,3482687,3,1170120,1172014,1171067,1894
3835,3482687,4,92096,92340,92218,244
3836,3482687,4,11269039,11269070,11269054,31
3837,3482687,5,398179,399011,398595,832
3838,3482687,5,7067434,7067664,7067549,230
3839,3482687,5,10878739,10878982,10878860,243
3840,3482687,5,18037534,18037822,18037678,288
3841,3482688,1,16269482,16269509,16269495,27
3842,3482688,2,2282437,2285112,2283774,2675
3843,3482688,2,8478943,8479194,8479068,251
3844,3482688,2,15216245,15216277,15216261,32
3845,3482688,3,10323023,10323909,10323466,886
3846,3482688,4,5226947,5227091,5227019,144
3847,3482688,5,10655471,10658351,10656911,2880
3848,3482689,1,28629054,28629358,28629206,304
3849,3482689,2,494756,495253,495004,497
3850,3482689,2,6505070,6505280,6505175,210
3851,3482689,2,13629504,13629845,13629674,341
3852,3482689,4,9818156,9822819,9820487,4663
3853,3482689,5,4568822,4569566,4569194,744
3854,3482689,5,26248958,26249951,26249454,993
3855,3482690,1,16483773,16483896,16483834,123
3856,3482690,1,18200180,18200704,18200442,524
3857,3482690,1,28372489,28373107,28372798,618
3858,3482690,2,6022394,6022568,6022481,174
3859,3482690,2,6850622,6851334,6850978,712
3860,3482690,2,16328729,16329376,16329052,647
3861,3482690,3,7602961,7603013,7602987,52
3862,3482690,3,15805300,15805359,15805329,59
3863,3482690,4,8648283,8648335,8648309,52
3864,3482690,5,1761060,1761857,1761458,797
3865,3482691,1,11450332,11450560,11450446,228
3866,3482691,1,26516486,26517661,26517073,1175
3867,3482691,1,28631972,28632788,28632380,816
3868,3482691,2,662778,663520,663149,742
3869,3482691,2,1706178,1707845,1707011,1667
3870,3482691,2,19145564,19145882,19145723,318
3871,3482691,3,9467537,9467949,9467743,412
3872,3482691,4,7769664,7769699,7769681,35
3873,3482691,5,324050,324248,324149,198
3874,3482691,5,20773237,20773781,20773509,544
3875,3482691,5,25819109,25819251,25819180,142
3876,3482692,1,12651908,12653934,12652921,2026
3877,3482692,3,10033467,10034558,10034012,1091
3878,3482692,4,9657597,9659188,9658392,1591
3879,3482692,4,17325353,17325462,17325407,109
3880,3482692,5,13879520,13879924,13879722,404
3881,3482693,1,483546,484340,483943,794
3882,3482693,1,8939485,8940149,8939817,664
3883,3482693,1,24788520,24788684,24788602,164
3884,3482693,2,12940327,12940354,12940340,27
3885,3482693,2,15995501,15995554,15995527,53
3886,3482693,3,17527774,17527958,17527866,184
3887,3482693,5,21321023,21322274,21321648,1251
3888,3482694,3,11812593,11813100,11812846,507
3889,3482694,3,16522274,16522649,16522461,375
3890,3482694,5,23767659,23767760,23767709,101
3891,3482695,1,26687275,26688771,26688023,1496
3892,3482695,1,28173991,28174069,28174030,78
3893,3482695,2,670747,671303,671025,556
3894,3482695,3,7760625,7761718,7761171,1093
3895,3482695,3,15658296,15658622,15658459,326
3896,3482695,4,7706243,7706271,7706257,28
3897,3482695,4,14541025,14542107,14541566,1082
3898,3482695,5,5758149,5760230,5759189,2081
3899,3482695,5,16609220,16610509,16609864,1289
3900,3482695,5,17760454,17760517,17760485,63
3901,3482696,1,20659859,20660608,20660233,749
3902,3482696,2,2180734,2181177,2180955,443
3903,3482696,4,17459338,17460203,17459770,865
3904,3482696,5,18220892,18222283,18221587,1391
3905,3482697,1,21569950,21571642,21570796,1692
3906,3482697,2,307368,309201,308284,1833
3907,3482697,3,5824048,5825150,5824599,1102
3908,3482697,3,9393971,9393983,9393977,12
3909,3482697,4,1417005,1417601,1417303,596
3910,3482697,5,21824627,21825469,21825048,842
3911,3482697,5,26020611,26020835,26020723,224
3912,3482700,1,7749634,7749685,7749659,51
3913,3482700,2,264073,264445,264259,372
3914,3482700,3,11759736,11759882,11759809,146
3915,3482700,3,16596206,16597333,16596769,1127
3916,3482700,4,7338556,7339275,7338915,719
3917,3482700,4,17804470,17804852,17804661,382
3918,3482700,5,754325,754787,754556,462
3919,3482700,5,17511151,17511171,17511161,20
3920,3482701,1,159382,159434,159408,52
3921,3482701,1,9128576,9128600,9128588,24
3922,3482701,1,17227398,17228137,17227767,739
3923,3482701,3,822830,823529,823179,699
3924,3482701,4,133129,133527,133328,398
3925,3482701,4,12444330,12444686,12444508,356
3926,3482701,5,6105504,6106784,6106144,1280
3927,3482701,5,17455406,17456077,17455741,671
3928,3482702,1,11139634,11141205,11140419,1571
3929,3482702,1,22674172,22675624,22674898,1452
3930,3482702,3,660906,661042,660974,136
3931,3482702,3,17240820,17241091,17240955,271
3932,3482702,4,7782731,7782801,7782766,70
3933,3482702,5,22636373,22636395,22636384,22
3934,3482703,1,2378381,2378854,2378617,473
3935,3482703,2,5778491,5778550,5778520,59
3936,3482703,2,5802761,5805579,5804170,2818
3937,3482703,3,8612605,8614787,8613696,2182
3938,3482703,3,17953057,17953311,17953184,254
3939,3482703,3,20061993,20062038,20062015,45
3940,3482704,1,10978328,10978516,10978422,188
3941,3482704,1,17453590,17453671,17453630,81
3942,3482704,1,23899174,23899832,23899503,658
3943,3482704,3,2846795,2849342,2848068,2547
3944,3482704,4,467333,467528,467430,195
3945,3482704,4,10801703,10801820,10801761,117
3946,3482704,4,11734781,11734970,11734875,189
3947,3482704,5,25143839,25146314,25145076,2475
3948,3482705,1,17396615,17396670,17396642,55
3949,3482705,1,24543730,24544134,24543932,404
3950,3482705,2,220106,220390,220248,284
3951,3482705,2,19144468,19145408,19144938,940
3952,3482705,3,14754243,14754790,14754516,547
3953,3482705,4,5352368,5352981,5352674,613
3954,3482706,1,11086250,11086475,11086362,225
3955,3482706,2,808401,810356,809378,1955
3956,3482706,2,11107886,11108051,11107968,165
3957,3482706,3,4842238,4850387,4846312,8149
3958,3482706,3,22872560,22873713,22873136,1153
3959,3482706,4,15231982,15232040,15232011,58
3960,3482706,5,2410122,2410270,2410196,148
3961,3482706,5,10029707,10030153,10029930,446
3962,3482706,5,20212189,20212202,20212195,13
3963,3482706,5,25376968,25377806,25377387,838
3964,3482707,1,3394421,3395748,3395084,1327
3965,3482707,1,17164220,17165242,17164731,1022
3966,3482707,1,20423771,20424545,20424158,774
3967,3482707,3,1484188,1484211,1484199,23
3968,3482707,4,12444686,12445003,12444844,317
3969,3482707,5,302852,304797,303824,1945
3970,3482707,5,14555244,14557502,14556373,2258
3971,3482707,5,21141760,21141872,21141816,112
3972,3482708,1,10020897,10020940,10020918,43
3973,3482708,1,12146452,12146973,12146712,521
3974,3482708,2,7984398,7985077,7984737,679
3975,3482708,3,8564968,8565423,8565195,455
3976,3482708,3,10798574,10799036,10798805,462
3977,3482708,4,9589540,9589639,9589589,99
3978,3482708,4,12838326,12841225,12839775,2899
3979,3482708,4,14138291,14147689,14142990,9398
3980,3482708,4,17651646,17652146,17651896,500
3981,3482708,4,18000059,18000922,18000490,863
3982,3482709,1,12067712,12067948,12067830,236
3983,3482709,1,20353008,20353186,20353097,178
3984,3482709,2,7125584,7127889,7126736,2305
3985,3482709,2,8500436,8500473,8500454,37
3986,3482709,3,7129014,7129324,7129169,310
3987,3482709,3,8155260,8156257,8155758,997
3988,3482709,5,10262596,10262872,10262734,276
3989,3482709,5,26605518,26605666,26605592,148
3990,3482713,1,2220491,2221155,2220823,664
3991,3482713,1,9988943,9989988,9989465,1045
3992,3482713,3,9833506,9834835,9834170,1329
3993,3482713,4,485454,485526,485490,72
3994,3482713,4,8459287,8459429,8459358,142
3995,3482713,5,794789,796960,795874,2171
3996,3482713,5,17718625,17719030,17718827,405
3997,3482713,5,20942024,20942142,20942083,118
3998,3482714,1,9130083,9130404,9130243,321
3999,3482714,1,9883410,9883491,9883450,81
4000,3482714,1,28572727,28573101,28572914,374
4001,3482714,2,16131129,16132590,16131859,1461
4002,3482714,3,19987515,19987703,19987609,188
4003,3482714,4,8732278,8732395,8732336,117
4004,3482714,4,9853631,9853644,9853637,13
4005,3482714,5,339721,344770,342245,5049
4006,3482714,5,21585702,21586561,21586131,859
4007,3482715,1,26726733,26726809,26726771,76
4008,3482715,2,6164728,6165260,6164994,532
4009,3482715,3,10143187,10144775,10143981,1588
4010,3482715,4,6794524,6796295,6795409,1771
4011,3482715,4,8459287,8459429,8459358,142
4012,3482716,1,17977856,17977946,17977901,90
4013,3482716,1,24403394,24403944,24403669,550
4014,3482716,2,163047,163192,163119,145
4015,3482716,2,9734637,9735513,9735075,876
4016,3482716,3,7609236,7609385,7609310,149
4017,3482716,3,10018891,10019460,10019175,569
4018,3482716,3,22131078,22131169,22131123,91
4019,3482716,5,25988740,25989368,25989054,628
4020,3482717,1,1241208,1241922,1241565,714
4021,3482717,1,13333778,13333880,13333829,102
4022,3482717,1,26078287,26078886,26078586,599
4023,3482717,2,276322,276481,276401,159
4024,3482717,2,1490976,1491084,1491030,108
4025,3482717,2,19287758,19287810,19287784,52
4026,3482717,3,7701000,7701448,7701224,448
4027,3482717,4,307756,308062,307909,306
4028,3482717,4,6574777,6574859,6574818,82
4029,3482717,5,771724,771885,771804,161
4030,3482718,1,21321121,21321298,21321209,177
4031,3482718,2,16650174,16650498,16650336,324
4032,3482718,3,425006,425009,425007,3
4033,3482718,3,3728308,3730322,3729315,2014
4034,3482718,4,325641,325825,325733,184
4035,3482718,4,2777432,2777592,2777512,160
4036,3482718,4,18175133,18175832,18175482,699
4037,3482719,1,2104435,2104632,2104533,197
4038,3482719,1,19902750,19904188,19903469,1438
4039,3482719,1,23951696,23953041,23952368,1345
4040,3482719,2,1442569,1443049,1442809,480
4041,3482719,2,12913529,12915368,12914448,1839
4042,3482719,3,8764670,8764878,8764774,208
4043,3482719,4,4825327,4826367,4825847,1040
4044,3482719,4,8056746,8056982,8056864,236
4045,3482720,1,7904927,7906505,7905716,1578
4046,3482720,1,17989303,17989751,17989527,448
4047,3482720,2,5011884,5012762,5012323,878
4048,3482720,2,7413171,7414440,7413805,1269
4049,3482720,2,14283619,14283686,14283652,67
4050,3482720,4,11399924,11401363,11400643,1439
4051,3482720,4,13221516,13222145,13221830,629
4052,3482720,5,1040127,1042378,1041252,2251
4053,3482720,5,19518289,19518830,19518559,541
4054,3482720,5,21579558,21579614,21579586,56
4055,3482721,1,2964558,2965237,2964897,679
4056,3482721,1,10114329,10116336,10115332,2007
4057,3482721,1,30053278,30053315,30053296,37
4058,3482721,2,13399243,13399403,13399323,160
4059,3482721,3,8575699,8576243,8575971,544
4060,3482721,4,40176,40960,40568,784
4061,3482721,4,9942080,9942238,9942159,158
4062,3482721,5,9943554,9944034,9943794,480
4063,3482721,5,26280722,26280898,26280810,176
4064,3482722,1,2324135,2325347,2324741,1212
4065,3482722,2,6133092,6133141,6133116,49
4066,3482722,2,17574572,17574584,17574578,12
4067,3482722,3,4731683,4732017,4731850,334
4068,3482722,3,17880936,17881063,17880999,127
4069,3482722,5,3795058,3795074,3795066,16
4070,3482722,5,16841688,16842897,16842292,1209
4071,3482722,5,21320251,21320256,21320253,5
4072,3482723,1,16232597,16232882,16232739,285
4073,3482723,4,12081947,12082004,12081975,57
4074,3482724,1,6349924,6350073,6349998,149
4075,3482724,1,26635028,26635060,26635044,32
4076,3482724,2,18328747,18328935,18328841,188
4077,3482724,3,10699535,10699544,10699539,9
4078,3482724,4,5315940,5316057,5315998,117
4079,3482724,4,7572440,7572529,7572484,89
4080,3482724,4,18244944,18245061,18245002,117
4081,3482724,5,1886,3739,2812,1853
4082,3482724,5,15399832,15400024,15399928,192
4083,3482725,1,29783698,29784304,29784001,606
4084,3482725,2,12369926,12369943,12369934,17
4085,3482725,2,13163476,13163538,13163507,62
4086,3482725,4,1591846,1592041,1591943,195
4087,3482725,5,3215460,3216209,3215834,749
4088,3482725,5,10170598,10170663,10170630,65
4089,3482726,1,10707152,10707347,10707249,195
4090,3482726,2,5678310,5678340,5678325,30
4091,3482726,3,16563605,16563825,16563715,220
4092,3482726,5,1204162,1204236,1204199,74
4093,3482726,5,7924167,7924288,7924227,121
4094,3482726,5,18636316,18636434,18636375,118
4095,3482727,1,1185563,1187417,1186490,1854
4096,3482727,1,9039785,9040212,9039998,427
4097,3482727,1,20669555,20670022,20669788,467
4098,3482727,2,5907264,5908057,5907660,793
4099,3482727,2,8183407,8183508,8183457,101
4100,3482727,3,6040527,6041263,6040895,736
4101,3482727,4,408295,410424,409359,2129
4102,3482727,4,924903,925681,925292,778
4103,3482727,5,13879520,13879924,13879722,404
4104,3482728,1,6837803,6838404,6838103,601
4105,3482728,1,20103539,20103694,20103616,155
4106,3482728,3,7223982,7224746,7224364,764
4107,3482728,3,8550473,8550777,8550625,304
4108,3482728,3,18749407,18749499,18749453,92
4109,3482728,4,8246889,8253467,8250178,6578
4110,3482728,5,1958754,1958875,1958814,121
4111,3482728,5,14873162,14873305,14873233,143
4112,3482729,1,8974855,8975427,8975141,572
4113,3482729,1,24885877,24885934,24885905,57
4114,3482729,2,1413280,1413333,1413306,53
4115,3482729,2,11290140,11290951,11290545,811
4116,3482729,3,11005832,11008782,11007307,2950
4117,3482729,3,11432774,11432925,11432849,151
4118,3482729,4,5647271,5647277,5647274,6
4119,3482729,5,9111979,9113475,9112727,1496
4120,3482730,1,9213916,9214342,9214129,426
4121,3482730,1,26909878,26910129,26910003,251
4122,3482730,2,12173368,12173479,12173423,111
4123,3482730,2,12913529,12915368,12914448,1839
4124,3482730,3,697271,697502,697386,231
4125,3482730,3,11755244,11755545,11755394,301
4126,3482730,3,16631311,16631870,16631590,559
4127,3482730,4,6936412,6937197,6936804,785
4128,3482730,5,7902496,7902871,7902683,375
4129,3482731,1,17475239,17475266,17475252,27
4130,3482731,4,16005163,16006560,16005861,1397
4131,3482731,5,18373880,18374279,18374079,399
4132,3482731,5,25008320,25009347,25008833,1027
4133,3482732,1,7456289,7456543,7456416,254
4134,3482732,2,923697,924439,924068,742
4135,3482732,2,6879679,6879762,6879720,83
4136,3482732,2,19089195,19089423,19089309,228
4137,3482732,3,7990989,7993232,7992110,2243
4138,3482732,3,17100947,17100957,17100952,10
4139,3482732,3,23157513,23157525,23157519,12
4140,3482732,4,295054,295314,295184,260
4141,3482732,4,13222016,13222145,13222080,129
4142,3482732,5,971062,974591,972826,3529
4143,3482732,5,17727126,17727195,17727160,69
4144,3482733,3,1090679,1091632,1091155,953
4145,3482733,3,5542773,5543703,5543238,930
4146,3482734,1,22820629,22820647,22820638,18
4147,3482734,1,27075345,27076176,27075760,831
4148,3482734,2,1555442,1556205,1555823,763
4149,3482734,2,12466312,12466445,12466378,133
4150,3482734,3,327619,331117,329368,3498
4151,3482734,3,16688460,16688520,16688490,60
4152,3482734,4,11312133,11314125,11313129,1992
4153,3482734,5,7674911,7675378,7675144,467
4154,3482734,5,18170467,18173199,18171833,2732
4155,3482734,5,23226787,23226975,23226881,188
4156,3482735,1,2520048,2520128,2520088,80
4157,3482735,1,19508235,19508608,19508421,373
4158,3482735,1,24309820,24310159,24309989,339
4159,3482735,2,9662293,9662680,9662486,387
4160,3482735,2,16228306,16228697,16228501,391
4161,3482735,4,77944,80192,79068,2248
4162,3482735,5,399621,400427,400024,806
4163,3482735,5,25209061,25209538,25209299,477
4164,3482736,1,25435574,25436005,25435789,431
4165,3482736,3,8459207,8460291,8459749,1084
4166,3482736,3,11128139,11128588,11128363,449
4167,3482736,3,16493876,16496619,16495247,2743
4168,3482737,1,1000662,1001598,1001130,936
4169,3482737,1,12472587,12472688,12472637,101
4170,3482737,2,295106,295317,295211,211
4171,3482737,2,7219792,7220379,7220085,587
4172,3482737,3,2878965,2879187,2879076,222
4173,3482737,3,4647862,4647901,4647881,39
4174,3482737,3,17238505,17238649,17238577,144
4175,3482737,4,11828831,11829150,11828990,319
4176,3482737,5,4340243,4340246,4340244,3
4177,3482738,1,17662882,17664378,17663630,1496
4178,3482738,2,15301195,15302129,15301662,934
4179,3482738,3,20517343,20519027,20518185,1684
4180,3482738,4,7592563,7592629,7592596,66
4181,3482738,5,764459,764523,764491,64
4182,3482738,5,7645626,7645645,7645635,19
4183,3482738,5,19663626,19663685,19663655,59
4184,3482739,1,13199739,13201601,13200670,1862
4185,3482739,2,12755076,12757165,12756120,2089
4186,3482739,3,3150711,3150836,3150773,125
4187,3482739,3,17905329,17905901,17905615,572
4188,3482739,4,459346,459662,459504,316
4189,3482739,4,7770135,7775601,7772868,5466
4190,3482739,5,10455483,10455664,10455573,181
4191,3482739,5,21506159,21506563,21506361,404
4192,3482739,5,21987016,21990561,21988788,3545
4193,3482739,5,26770982,26771186,26771084,204
4194,3482740,1,4277492,4277687,4277589,195
4195,3482740,1,21040574,21041533,21041053,959
4196,3482740,2,19464744,19467282,19466013,2538
4197,3482740,3,9581758,9581830,9581794,72
4198,3482740,3,11081565,11082359,11081962,794
4199,3482740,4,755572,755640,755606,68
4200,3482740,4,8185991,8186028,8186009,37
4201,3482740,4,11743712,11744032,11743872,320
4202,3482740,5,23996911,23997465,23997188,554
4203,3482741,1,10467009,10467037,10467023,28
4204,3482741,1,25378760,25379938,25379349,1178
4205,3482741,2,12262891,12263658,12263274,767
4206,3482741,3,11161075,11161769,11161422,694
4207,3482741,4,9120656,9121981,9121318,1325
4208,3482741,4,13715835,13716221,13716028,386
4209,3482741,5,1139548,1140076,1139812,528
4210,3482745,1,4875390,4876547,4875968,1157
4211,3482745,1,13289066,13289876,13289471,810
4212,3482745,1,25682763,25683038,25682900,275
4213,3482745,2,11150413,11150486,11150449,73
4214,3482745,2,19019418,19020450,19019934,1032
4215,3482745,3,11104932,11105372,11105152,440
4216,3482745,3,18294644,18294660,18294652,16
4217,3482745,5,1930797,1930804,1930800,7
4218,3482745,5,15896661,15896730,15896695,69
4219,3482745,5,22843535,22844654,22844094,1119
4220,3482746,2,7465953,7467175,7466564,1222
4221,3482746,2,11905913,11907623,11906768,1710
4222,3482746,2,19255517,19255705,19255611,188
4223,3482746,3,7216366,7216968,7216667,602
4224,3482746,3,12357748,12358017,12357882,269
4225,3482746,4,5603307,5603765,5603536,458
4226,3482746,5,14640129,14640160,14640144,31
4227,3482747,1,9447325,9447358,9447341,33
4228,3482747,1,25409822,25410025,25409923,203
4229,3482747,2,1500375,1500705,1500540,330
4230,3482747,2,10134529,10135502,10135015,973
4231,3482747,3,3155125,3155774,3155449,649
4232,3482747,3,21107942,21108641,21108291,699
4233,3482747,4,5123401,5123494,5123447,93
4234,3482747,4,5316326,5316459,5316392,133
4235,3482747,5,3052971,3054764,3053867,1793
4236,3482747,5,16593572,16594171,16593871,599
4237,3482747,5,19175937,19175975,19175956,38
4238,3482748,1,1459918,1461086,1460502,1168
4239,3482748,1,11846311,11847238,11846774,927
4240,3482748,2,6889859,6889903,6889881,44
4241,3482748,2,16763799,16764003,16763901,204
4242,3482748,2,19013031,19013900,19013465,869
4243,3482748,3,10032520,10034558,10033539,2038
4244,3482748,4,5739140,5743665,5741402,4525
4245,3482748,4,6212832,6212999,6212915,167
4246,3482748,4,12294726,12295798,12295262,1072
4247,3482748,5,5867362,5868932,5868147,1570
4248,3482748,5,10472875,10473189,10473032,314
4249,3482748,5,26253943,26254698,26254320,755
4250,3482749,1,6920855,6921220,6921037,365
4251,3482749,2,1155301,1155623,1155462,322
4252,3482749,2,16331355,16332975,16332165,1620
4253,3482749,2,17722465,17723552,17723008,1087
4254,3482749,4,6272207,6272767,6272487,560
4255,3482749,4,9249069,9250172,9249620,1103
4256,3482749,4,17985764,17986389,17986076,625
4257,3482749,5,14814235,14814594,14814414,359
4258,3482750,1,16269635,16269691,16269663,56
4259,3482750,2,2928473,2928694,2928583,221
4260,3482750,3,3154073,3154211,3154142,138
4261,3482750,4,378017,378336,378176,319
4262,3482750,4,9414630,9415541,9415085,911
4263,3482750,5,13479821,13479884,13479852,63
4264,3482750,5,21610210,21610336,21610273,126
4265,3482750,5,22573939,22573961,22573950,22
4266,3482751,1,9416490,9417217,9416853,727
4267,3482751,1,17247129,17247480,17247304,351
4268,3482751,1,26262222,26262231,26262226,9
4269,3482751,3,10610313,10610919,10610616,606
4270,3482751,4,11750149,11750773,11750461,624
4271,3482751,4,12861542,12861962,12861752,420
4272,3482751,5,9686125,9687949,9687037,1824
4273,3482751,5,21141872,21143681,21142776,1809
4274,3482751,5,25615706,25616089,25615897,383
4275,3482752,1,3651857,3653273,3652565,1416
4276,3482752,1,25698186,25698887,25698536,701
4277,3482752,1,30408738,30408914,30408826,176
4278,3482752,2,332837,334781,333809,1944
4279,3482752,3,7773592,7774209,7773900,617
4280,3482752,4,8890384,8890595,8890489,211
4281,3482752,5,15224970,15225141,15225055,171
4282,3482752,5,23968492,23969467,23968979,975
4283,3482753,1,11250467,11250557,11250512,90
4284,3482753,1,19473405,19473456,19473430,51
4285,3482753,1,23303404,23304548,23303976,1144
4286,3482753,2,9541253,9541409,9541331,156
4287,3482753,3,2490157,2490346,2490251,189
4288,3482753,3,7431938,7433291,7432614,1353
4289,3482753,4,7027632,7029149,7028390,1517
4290,3482753,4,11720848,11721887,11721367,1039
4291,3482753,5,8291908,8292400,8292154,492
4292,3482753,5,22044681,22044731,22044706,50
4293,3482753,5,26133929,26134237,26134083,308
4294,3482754,1,11467988,11468046,11468017,58
4295,3482754,1,20702696,20702750,20702723,54
4296,3482754,2,6866549,6866710,6866629,161
4297,3482754,3,15353163,15354830,15353996,1667
4298,3482754,3,15672401,15674672,15673536,2271
4299,3482754,5,6769252,6771205,6770228,1953
4300,3482754,5,17737363,17737721,17737542,358
4301,3482754,5,25988740,25989368,25989054,628
4302,3482755,1,4595803,4596022,4595912,219
4303,3482755,1,23722005,23722985,23722495,980
4304,3482755,1,25135161,25135511,25135336,350
4305,3482755,3,5710396,5713117,5711756,2721
4306,3482755,3,16322690,16322909,16322799,219
4307,3482755,4,5165707,5165967,5165837,260
4308,3482755,4,6794205,6794524,6794364,319
4309,3482755,4,16555075,16555308,16555191,233
4310,3482755,5,1947059,1948070,1947564,1011
4311,3482756,1,13080227,13081025,13080626,798
4312,3482756,1,16276866,16277144,16277005,278
4313,3482756,1,23762140,23763473,23762806,1333
4314,3482756,2,237631,237767,237699,136
4315,3482756,2,15352002,15352319,15352160,317
4316,3482756,4,14975648,14975827,14975737,179
4317,3482757,1,6625801,6627522,6626661,1721
4318,3482757,2,15723768,15724136,15723952,368
4319,3482757,3,7888251,7888274,7888262,23
4320,3482757,4,5007188,5007513,5007350,325
4321,3482757,5,14591307,14591404,14591355,97
4322,3482758,1,17392920,17393382,17393151,462
4323,3482758,2,759087,762118,760602,3031
4324,3482758,2,10203691,10203756,10203723,65
4325,3482758,3,8690574,8690916,8690745,342
4326,3482758,4,92340,92906,92623,566
4327,3482758,4,17667593,17669581,17668587,1988
4328,3482759,1,16141475,16141666,16141570,191
4329,3482759,1,16600618,16600933,16600775,315
4330,3482759,1,17913647,17913798,17913722,151
4331,3482759,1,27227779,27227838,27227808,59
4332,3482759,2,9389844,9392575,9391209,2731
4333,3482759,3,1153628,1153675,1153651,47
4334,3482759,3,8559456,8560723,8560089,1267
4335,3482759,3,19279908,19280300,19280104,392
4336,3482759,4,17432177,17432639,17432408,462
4337,3482760,1,1429954,1431611,1430782,1657
4338,3482760,1,16808367,16808652,16808509,285
4339,3482760,1,19306355,19306619,19306487,264
4340,3482760,2,1431705,1431752,1431728,47
4341,3482760,2,11638933,11640628,11639780,1695
4342,3482760,4,12884568,12885858,12885213,1290
4343,3482760,5,1581918,1582024,1581971,106
4344,3482760,5,20537134,20538380,20537757,1246
4345,3482761,1,5371087,5371088,5371087,1
4346,3482761,1,9610139,9610438,9610288,299
4347,3482761,1,19226133,19226200,19226166,67
4348,3482761,1,24700907,24701208,24701057,301
4349,3482761,1,26333535,26333652,26333593,117
4350,3482761,2,8544356,8544843,8544599,487
4351,3482761,2,15053414,15053848,15053631,434
4352,3482761,2,16651892,16651898,16651895,6
4353,3482761,3,8690916,8691061,8690988,145
4354,3482761,3,22496218,22497449,22496833,1231
4355,3482761,4,17793566,17797773,17795669,4207
4356,3482761,5,14975571,14975828,14975699,257
4357,3482762,1,5854151,5854281,5854216,130
4358,3482762,1,19840933,19843764,19842348,2831
4359,3482762,3,8676583,8677758,8677170,1175
4360,3482762,3,11921664,11922263,11921963,599
4361,3482762,3,20530484,20530611,20530547,127
4362,3482762,4,5701150,5703908,5702529,2758
4363,3482762,5,15067757,15067845,15067801,88
4364,3482763,2,1151284,1151513,1151398,229
4365,3482763,2,11877722,11878974,11878348,1252
4366,3482763,3,18072490,18073014,18072752,524
4367,3482763,4,5352981,5353011,5352996,30
4368,3482764,1,1574819,1575118,1574968,299
4369,3482764,2,803576,805403,804489,1827
4370,3482764,2,18459790,18460043,18459916,253
4371,3482764,3,10312002,10312938,10312470,936
4372,3482764,3,15925528,15926090,15925809,562
4373,3482764,3,21222633,21222966,21222799,333
4374,3482764,5,6928014,6928072,6928043,58
4375,3482764,5,21380626,21380866,21380746,240
4376,3482765,1,6228088,6228807,6228447,719
4377,3482765,1,16728358,16728399,16728378,41
4378,3482765,2,8793837,8794332,8794084,495
4379,3482765,2,9276181,9276184,9276182,3
4380,3482765,3,262833,265272,264052,2439
4381,3482765,3,2705536,2706025,2705780,489
4382,3482765,3,18731363,18733297,18732330,1934
4383,3482765,4,8785612,8786994,8786303,1382
4384,3482766,1,12657210,12657871,12657540,661
4385,3482766,2,1499978,1500266,1500122,288
4386,3482766,3,15616129,15616191,15616160,62
4387,3482766,4,4871734,4871881,4871807,147
4388,3482766,4,11761553,11762424,11761988,871
4389,3482766,5,361701,362167,361934,466
4390,3482766,5,15578858,15578862,15578860,4
4391,3482766,5,16795898,16795981,16795939,83
4392,3482767,1,1238986,1239354,1239170,368
4393,3482767,1,7805854,7806650,7806252,796
4394,3482767,1,22598489,22599379,22598934,890
4395,3482767,1,25665913,25666208,25666060,295
4396,3482767,2,11702749,11702893,11702821,144
4397,3482767,3,4812413,4813350,4812881,937
4398,3482767,4,8823425,8824454,8823939,1029
4399,3482767,5,20902496,20902994,20902745,498
4400,3482768,1,8398577,8398700,8398638,123
4401,3482768,1,19110525,19110775,19110650,250
4402,3482768,1,22040500,22042012,22041256,1512
4403,3482768,4,343161,344085,343623,924
4404,3482768,4,9081483,9081712,9081597,229
4405,3482768,5,13866878,13867014,13866946,136
4406,3482769,5,15705771,15705793,15705782,22
4407,3482770,1,2095718,2095893,2095805,175
4408,3482770,1,17331442,17335316,17333379,3874
4409,3482770,1,25314106,25314600,25314353,494
4410,3482770,2,9987872,9988726,9988299,854
4411,3482770,2,18521055,18528032,18524543,6977
4412,3482770,3,8905291,8906377,8905834,1086
4413,3482770,3,19508998,19509091,19509044,93
4414,3482770,4,5709729,5710434,5710081,705
4415,3482770,4,7337062,7337077,7337069,15
4416,3482770,5,5671674,5671767,5671720,93
4417,3482770,5,21952706,21952906,21952806,200
4418,3482771,1,16808652,16808698,16808675,46
4419,3482771,1,24410801,24412220,24411510,1419
4420,3482771,2,11876318,11876632,11876475,314
4421,3482771,3,5255728,5255916,5255822,188
4422,3482771,3,8171871,8174634,8173252,2763
4423,3482771,4,7774259,7775601,7774930,1342
4424,3482771,5,8165645,8165656,8165650,11
4425,3482771,5,21683022,21685383,21684202,2361
4426,3482772,1,1583709,1583741,1583725,32
4427,3482772,1,8333929,8334442,8334185,513
4428,3482772,1,19687658,19687846,19687752,188
4429,3482772,1,25403659,25404253,25403956,594
4430,3482772,2,19019275,19020654,19019964,1379
4431,3482772,3,14954686,14954769,14954727,83
4432,3482772,4,5761385,5765774,5763579,4389
4433,3482772,4,14270722,14272213,14271467,1491
4434,3482772,5,16290802,16291519,16291160,717
4435,3482773,1,8936541,8936911,8936726,370
4436,3482773,2,746218,746705,746461,487
4437,3482773,2,10176593,10177070,10176831,477
4438,3482773,2,18789205,18789457,18789331,252
4439,3482773,3,450845,454620,452732,3775
4440,3482773,3,7106768,7107253,7107010,485
4441,3482773,3,17611707,17611837,17611772,130
4442,3482773,3,19530993,19531128,19531060,135
4443,3482773,4,273749,273948,273848,199
4444,3482773,4,16718309,16722290,16720299,3981
4445,3482773,5,844821,844950,844885,129
4446,3482773,5,22255998,22256339,22256168,341
4447,3482773,5,22652079,22652443,22652261,364
4448,3482774,1,12321745,12324629,12323187,2884
4449,3482774,1,16143028,16143052,16143040,24
4450,3482774,1,25698933,25702694,25700813,3761
4451,3482774,2,16415706,16417464,16416585,1758
4452,3482774,5,9659262,9659394,9659328,132
4453,3482774,5,23081988,23086039,23084013,4051
4454,3482775,1,573659,574104,573881,445
4455,3482775,1,19881677,19881959,19881818,282
4456,3482775,1,23092828,23092977,23092902,149
4457,3482775,2,154228,155225,154726,997
4458,3482775,2,7411218,7411448,7411333,230
4459,3482775,2,15487911,15488275,15488093,364
4460,3482775,3,7084419,7084969,7084694,550
4461,3482775,4,96436,96923,96679,487
4462,3482775,4,11920934,11921228,11921081,294
4463,3482775,5,5825346,5825459,5825402,113
4464,3482775,5,8848670,8849169,8848919,499
4465,3482775,5,14067592,14068970,14068281,1378
4466,3482776,2,1124985,1125048,1125016,63
4467,3482776,2,6398610,6399236,6398923,626
4468,3482776,2,17964446,17967177,17965811,2731
4469,3482776,3,1064638,1064688,1064663,50
4470,3482776,3,18567669,18568081,18567875,412
4471,3482776,4,5371219,5371919,5371569,700
4472,3482776,5,6055609,6055712,6055660,103
4473,3482776,5,13339749,13342049,13340899,2300
4474,3482777,2,1136489,1136530,1136509,41
4475,3482777,2,6451501,6451890,6451695,389
4476,3482777,2,17785473,17789107,17787290,3634
4477,3482777,3,1061135,1062044,1061589,909
4478,3482777,3,18576295,18576751,18576523,456
4479,3482777,4,5373673,5373979,5373826,306
4480,3482777,5,6254058,6254165,6254111,107
4481,3482777,5,10931389,10931725,10931557,336
4482,3482778,1,25236380,25236674,25236527,294
4483,3482778,3,15632867,15632986,15632926,119
4484,3482778,5,941832,943871,942851,2039
4485,3482778,5,17949290,17949406,17949348,116
4486,3482778,5,20637501,20637681,20637591,180
4487,3482779,1,1424528,1424666,1424597,138
4488,3482779,1,7239962,7240312,7240137,350
4489,3482779,2,83347,83447,83397,100
4490,3482779,2,7377832,7377942,7377887,110
4491,3482779,2,13094317,13094318,13094317,1
4492,3482779,3,7215391,7216079,7215735,688
4493,3482779,3,10459466,10459530,10459498,64
4494,3482779,3,18838374,18838695,18838534,321
4495,3482779,4,155605,155806,155705,201
4496,3482779,5,6429155,6429567,6429361,412
4497,3482780,1,23406244,23406519,23406381,275
4498,3482780,1,23767907,23768013,23767960,106
4499,3482780,2,250337,250560,250448,223
4500,3482780,2,13788435,13788474,13788454,39
4501,3482780,2,18811880,18812187,18812033,307
4502,3482780,3,11037672,11037730,11037701,58
4503,3482780,4,6582955,6583020,6582987,65
4504,3482780,4,9041916,9043175,9042545,1259
4505,3482780,5,8364227,8364255,8364241,28
4506,3482781,1,9321014,9322541,9321777,1527
4507,3482781,1,27857058,27859322,27858190,2264
4508,3482781,2,6511984,6512023,6512003,39
4509,3482781,3,7646503,7646616,7646559,113
4510,3482781,3,22462677,22465182,22463929,2505
4511,3482781,5,18922857,18923643,18923250,786
4512,3482781,5,21986650,21987016,21986833,366
4513,3482784,1,13050534,13050649,13050591,115
4514,3482784,1,19653549,19656476,19655012,2927
4515,3482784,1,25531765,25536975,25534370,5210
4516,3482784,2,2311799,2312714,2312256,915
4517,3482784,2,9976721,9977763,9977242,1042
4518,3482784,2,16637124,16637127,16637125,3
4519,3482784,3,9110643,9111432,9111037,789
4520,3482784,3,18342272,18342409,18342340,137
4521,3482784,4,6576961,6577968,6577464,1007
4522,3482784,5,5177605,5179423,5178514,1818
4523,3482784,5,14315124,14316600,14315862,1476
4524,3482785,1,6919637,6920537,6920087,900
4525,3482785,1,8534770,8534937,8534853,167
4526,3482785,1,19435279,19435711,19435495,432
4527,3482785,1,29419794,29419979,29419886,185
4528,3482785,2,19531615,19533248,19532431,1633
4529,3482785,3,6656639,6661154,6658896,4515
4530,3482785,3,22948303,22949757,22949030,1454
4531,3482785,4,4792239,4793168,4792703,929
4532,3482785,4,17973069,17973522,17973295,453
4533,3482785,5,1398369,1398571,1398470,202
4534,3482785,5,4748720,4749292,4749006,572
4535,3482785,5,21967370,21967396,21967383,26
4536,3482786,1,2198174,2200039,2199106,1865
4537,3482786,1,9475365,9480827,9478096,5462
4538,3482786,2,1104474,1106110,1105292,1636
4539,3482786,2,9722294,9722529,9722411,235
4540,3482786,3,8889896,8890637,8890266,741
4541,3482786,3,9540122,9540152,9540137,30
4542,3482786,3,17024236,17024413,17024324,177
4543,3482786,4,1187190,1187573,1187381,383
4544,3482786,5,8792239,8792885,8792562,646
4545,3482786,5,13770925,13771616,13771270,691
4546,3482787,1,7259241,7259398,7259319,157
4547,3482787,1,21309106,21309200,21309153,94
4548,3482787,4,8089123,8091304,8090213,2181
4549,3482788,1,6954566,6955434,6955000,868
4550,3482788,1,7101503,7101554,7101528,51
4551,3482788,1,19425165,19425389,19425277,224
4552,3482788,2,17751405,17751579,17751492,174
4553,3482788,4,13140931,13141049,13140990,118
4554,3482788,5,17943234,17945603,17944418,2369
4555,3482789,1,10373703,10374128,10373915,425
4556,3482789,1,24793590,24793657,24793623,67
4557,3482789,2,2896598,2897779,2897188,1181
4558,3482789,2,19162515,19163028,19162771,513
4559,3482789,3,16138770,16138907,16138838,137
4560,3482789,4,13884526,13884947,13884736,421
4561,3482789,5,18003982,18004360,18004171,378
4562,3482789,5,23978797,23979010,23978903,213
4563,3482790,1,3398442,3398640,3398541,198
4564,3482790,1,8975428,8975583,8975505,155
4565,3482790,1,17273576,17273752,17273664,176
4566,3482790,2,2236452,2236471,2236461,19
4567,3482790,2,9540935,9540969,9540952,34
4568,3482790,3,5455955,5457080,5456517,1125
4569,3482790,3,9605751,9605969,9605860,218
4570,3482790,5,310062,310449,310255,387
4571,3482791,1,9226039,9226241,9226140,202
4572,3482791,1,17804955,17806487,17805721,1532
4573,3482791,1,18731393,18732149,18731771,756
4574,3482791,1,20216902,20216964,20216933,62
4575,3482791,2,1031226,1031470,1031348,244
4576,3482791,2,9602485,9607582,9605033,5097
4577,3482791,4,1510100,1510313,1510206,213
4578,3482792,1,16233207,16233755,16233481,548
4579,3482792,1,20768235,20768323,20768279,88
4580,3482792,2,2350736,2350818,2350777,82
4581,3482792,2,15997353,15997654,15997503,301
4582,3482792,3,3189802,3189952,3189877,150
4583,3482792,3,6096875,6097310,6097092,435
4584,3482792,3,9497318,9498042,9497680,724
4585,3482792,4,10037064,10037105,10037084,41
4586,3482792,4,17389879,17391829,17390854,1950
4587,3482792,5,976950,977311,977130,361
4588,3482792,5,8996860,8998337,8997598,1477
4589,3482792,5,15616500,15616747,15616623,247
4590,3482792,5,21402620,21402723,21402671,103
4591,3482793,1,11921283,11925202,11923242,3919
4592,3482793,2,6709429,6710245,6709837,816
4593,3482793,2,14533472,14535713,14534592,2241
4594,3482793,2,16909351,16912657,16911004,3306
4595,3482793,4,5123494,5123588,5123541,94
4596,3482793,4,7344668,7345316,7344992,648
4597,3482793,5,9302863,9303059,9302961,196
4598,3482794,1,5333694,5335212,5334453,1518
4599,3482794,1,19314949,19315172,19315060,223
4600,3482794,1,27850577,27850612,27850594,35
4601,3482794,2,147111,149246,148178,2135
4602,3482794,2,14280341,14280631,14280486,290
4603,3482794,3,1735738,1737204,1736471,1466
4604,3482794,3,20719532,20720693,20720112,1161
4605,3482794,4,190806,192744,191775,1938
4606,3482794,4,12265820,12267168,12266494,1348
4607,3482794,4,14831922,14832198,14832060,276
4608,3482794,5,2379934,2380130,2380032,196
4609,3482794,5,17722669,17722723,17722696,54
4610,3482795,1,16037193,16038084,16037638,891
4611,3482795,1,24551730,24551881,24551805,151
4612,3482795,2,16916722,16916847,16916784,125
4613,3482795,3,5353351,5353525,5353438,174
4614,3482795,3,10357757,10358232,10357994,475
4615,3482795,4,5709729,5709914,5709821,185
4616,3482795,5,5629876,5635558,5632717,5682
4617,3482795,5,10492809,10493223,10493016,414
4618,3482796,1,12218244,12218522,12218383,278
4619,3482796,1,23767907,23768013,23767960,106
4620,3482796,1,26937661,26938285,26937973,624
4621,3482796,4,10370571,10370728,10370649,157
4622,3482796,4,13247449,13249121,13248285,1672
4623,3482796,5,5398297,5398322,5398309,25
4624,3482797,1,6643397,6643505,6643451,108
4625,3482797,1,16145724,16145785,16145754,61
4626,3482797,1,19511199,19512861,19512030,1662
4627,3482797,3,9051326,9052408,9051867,1082
4628,3482797,4,7762692,7762922,7762807,230
4629,3482797,4,10451925,10451967,10451946,42
4630,3482797,4,11889625,11890771,11890198,1146
4631,3482797,5,1275774,1276117,1275945,343
4632,3482797,5,10001205,10002655,10001930,1450
4633,3482797,5,14722636,14722871,14722753,235
4634,3482798,1,3926432,3926892,3926662,460
4635,3482798,1,18165937,18166987,18166462,1050
4636,3482798,2,1715353,1719022,1717187,3669
4637,3482798,2,11664769,11664901,11664835,132
4638,3482798,2,15288675,15289938,15289306,1263
4639,3482798,3,17527026,17527958,17527492,932
4640,3482798,4,14316821,14316874,14316847,53
4641,3482798,5,3759483,3760161,3759822,678
4642,3482798,5,10180614,10181341,10180977,727
4643,3482798,5,22652443,22653398,22652920,955
4644,3482799,1,4341581,4342530,4342055,949
4645,3482799,1,4760037,4760346,4760191,309
4646,3482799,1,7064177,7064318,7064247,141
4647,3482799,1,7756296,7756508,7756402,212
4648,3482799,1,27701703,27702605,27702154,902
4649,3482799,1,28114996,28115651,28115323,655
4650,3482799,1,28960616,28963182,28961899,2566
4651,3482799,3,8245247,8245589,8245418,342
4652,3482799,4,6410806,6411090,6410948,284
4653,3482799,4,14044027,14044059,14044043,32
4654,3482799,5,7996330,7996909,7996619,579
4655,3482799,5,19723241,19723624,19723432,383
4656,3482799,5,20232110,20232182,20232146,72
4657,3482800,1,12218244,12218522,12218383,278
4658,3482800,2,7873890,7874157,7874023,267
4659,3482800,3,1832868,1832965,1832916,97
4660,3482800,4,1285692,1285818,1285755,126
4661,3482800,4,17427603,17427682,17427642,79
4662,3482800,5,26053996,26054418,26054207,422
4663,3482801,1,4155241,4155277,4155259,36
4664,3482801,1,4607466,4607622,4607544,156
4665,3482801,1,5181596,5182982,5182289,1386
4666,3482801,1,19247646,19247665,19247655,19
4667,3482801,1,29075141,29076082,29075611,941
4668,3482801,1,30352724,30353194,30352959,470
4669,3482801,2,6761183,6761284,6761233,101
4670,3482801,2,10730651,10731098,10730874,447
4671,3482801,2,11180431,11182425,11181428,1994
4672,3482801,4,2221029,2223619,2222324,2590
4673,3482801,4,2828016,2828054,2828035,38
4674,3482801,4,5205902,5206241,5206071,339
4675,3482801,4,6298903,6300120,6299511,1217
4676,3482801,4,7039755,7040370,7040062,615
4677,3482801,4,8087364,8087582,8087473,218
4678,3482801,4,9889368,9889414,9889391,46
4679,3482801,4,10976359,10976568,10976463,209
4680,3482801,4,15223189,15223494,15223341,305
4681,3482801,4,16278033,16278301,16278167,268
4682,3482801,5,3484646,3486260,3485453,1614
4683,3482801,5,4543931,4547490,4545710,3559
4684,3482801,5,6071545,6071603,6071574,58
4685,3482801,5,8657259,8657713,8657486,454
4686,3482801,5,9647656,9647706,9647681,50
4687,3482801,5,14952597,14954320,14953458,1723
4688,3482801,5,15746038,15747369,15746703,1331
4689,3482801,5,17315090,17315223,17315156,133
4690,3482801,5,25063799,25063965,25063882,166
4691,3482801,5,26394294,26395053,26394673,759
4692,3482801,5,26816922,26817862,26817392,940
4693,3482802,2,1100861,1101431,1101146,570
4694,3482802,2,8210975,8218641,8214808,7666
4695,3482802,3,5818784,5820624,5819704,1840
4696,3482802,3,11755670,11755882,11755776,212
4697,3482802,5,13820335,13822087,13821211,1752
4698,3482802,5,25942775,25947111,25944943,4336
4699,3482803,1,17305086,17305114,17305100,28
4700,3482803,2,1934087,1934124,1934105,37
4701,3482803,2,6227972,6228462,6228217,490
4702,3482803,4,178452,179114,178783,662
4703,3482803,5,16479774,16480078,16479926,304
4704,3482804,1,6125590,6125607,6125598,17
4705,3482804,3,10154655,10154823,10154739,168
4706,3482804,4,10390310,10390350,10390330,40
4707,3482805,1,17308811,17319252,17314031,10441
4708,3482805,2,1926910,1927287,1927098,377
4709,3482805,2,6227500,6227769,6227634,269
4710,3482805,4,134356,135263,134809,907
4711,3482805,5,16482106,16485056,16483581,2950
4712,3482806,1,16776225,16777627,16776926,1402
4713,3482806,2,16477899,16480436,16479167,2537
4714,3482806,3,3942846,3944438,3943642,1592
4715,3482806,3,9848734,9849605,9849169,871
4716,3482806,4,201733,202037,201885,304
4717,3482806,4,5143504,5144066,5143785,562
4718,3482806,5,510322,510807,510564,485
4719,3482806,5,16647862,16648864,16648363,1002
4720,3482806,5,21320277,21320395,21320336,118
4721,3482807,1,2502279,2503415,2502847,1136
4722,3482807,2,1936443,1936513,1936478,70
4723,3482807,2,12140463,12140659,12140561,196
4724,3482807,3,1777370,1777504,1777437,134
4725,3482807,3,6236612,6236682,6236647,70
4726,3482807,4,292391,292979,292685,588
4727,3482807,4,12354437,12355131,12354784,694
4728,3482807,5,16765842,16766048,16765945,206
4729,3482807,5,21389400,21389751,21389575,351
4730,3482808,1,7724815,7725002,7724908,187
4731,3482808,1,28425698,28425782,28425740,84
4732,3482808,2,5462242,5462364,5462303,122
4733,3482808,2,17416055,17416082,17416068,27
4734,3482808,3,4812413,4813350,4812881,937
4735,3482808,3,21144288,21144952,21144620,664
4736,3482808,4,5401472,5402304,5401888,832
4737,3482808,4,16828545,16829878,16829211,1333
4738,3482808,5,14067592,14068970,14068281,1378
4739,3482808,5,19832122,19832269,19832195,147
4740,3482809,1,20865647,20866378,20866012,731
4741,3482809,1,26720927,26721313,26721120,386
4742,3482809,2,7672353,7672516,7672434,163
4743,3482809,2,16065826,16066513,16066169,687
4744,3482809,4,5297446,5297858,5297652,412
4745,3482809,4,9161289,9161500,9161394,211
4746,3482809,4,17268610,17270443,17269526,1833
4747,3482809,5,20300346,20300440,20300393,94
4748,3482810,1,11929458,11936615,11933036,7157
4749,3482810,3,12131714,12133794,12132754,2080
4750,3482810,4,17803034,17803159,17803096,125
4751,3482810,5,26691,27215,26953,524
4752,3482810,5,536670,537261,536965,591
4753,3482810,5,9155491,9156131,9155811,640
4754,3482810,5,14008663,14009167,14008915,504
4755,3482810,5,17493927,17494020,17493973,93
4756,3482810,5,17988947,17989480,17989213,533
4757,3482811,1,4559620,4559778,4559699,158
4758,3482811,1,21993661,21993714,21993687,53
4759,3482811,2,13329043,13329336,13329189,293
4760,3482811,4,17325353,17325462,17325407,109
4761,3482811,5,20381715,20381874,20381794,159
4762,3482812,1,4508586,4508589,4508587,3
4763,3482812,1,12935108,12935199,12935153,91
4764,3482812,2,7920518,7922068,7921293,1550
4765,3482812,3,1055777,1056029,1055903,252
4766,3482812,3,10699328,10699459,10699393,131
4767,3482812,3,16565362,16565564,16565463,202
4768,3482812,3,21032150,21032926,21032538,776
4769,3482812,4,7428504,7428863,7428683,359
4770,3482812,5,15396521,15397222,15396871,701
4771,3482813,1,16239059,16239151,16239105,92
4772,3482813,1,25304841,25305004,25304922,163
4773,3482813,2,5833724,5833980,5833852,256
4774,3482813,4,699124,699274,699199,150
4775,3482813,4,7317608,7318570,7318089,962
4776,3482813,5,21420973,21422508,21421740,1535
4777,3482814,1,4818747,4818797,4818772,50
4778,3482814,1,18991999,19000316,18996157,8317
4779,3482814,2,387072,387383,387227,311
4780,3482814,2,9894782,9895052,9894917,270
4781,3482814,3,9401390,9401529,9401459,139
4782,3482814,3,19252787,19252936,19252861,149
4783,3482814,4,1268421,1268946,1268683,525
4784,3482814,4,7257487,7258187,7257837,700
4785,3482814,4,10999272,10999432,10999352,160
4786,3482815,1,12462495,12462668,12462581,173
4787,3482815,1,22199456,22199587,22199521,131
4788,3482815,2,2308143,2309052,2308597,909
4789,3482815,2,13093646,13094011,13093828,365
4790,3482815,3,20393189,20393437,20393313,248
4791,3482815,4,7668387,7668689,7668538,302
4792,3482815,4,18449644,18451246,18450445,1602
4793,3482815,5,10287568,10290254,10288911,2686
4794,3482815,5,14997723,14997787,14997755,64
4795,3482815,5,21970508,21971571,21971039,1063
4796,3482816,1,677970,678528,678249,558
4797,3482816,1,1467443,1468650,1468046,1207
4798,3482816,1,7944580,7944837,7944708,257
4799,3482816,1,9800892,9801636,9801264,744
4800,3482816,1,17229825,17229846,17229835,21
4801,3482816,1,18741482,18743816,18742649,2334
4802,3482816,1,19151620,19152587,19152103,967
4803,3482816,1,19585394,19586048,19585721,654
4804,3482816,1,21436717,21437156,21436936,439
4805,3482816,1,23022234,23022650,23022442,416
4806,3482816,1,24345440,24345538,24345489,98
4807,3482816,1,26264851,26264942,26264896,91
4808,3482816,2,524465,526485,525475,2020
4809,3482816,3,9627901,9628902,9628401,1001
4810,3482816,3,10169901,10169929,10169915,28
4811,3482816,3,11052958,11052970,11052964,12
4812,3482816,3,11768706,11768733,11768719,27
4813,3482816,3,14941889,14942387,14942138,498
4814,3482816,3,16632426,16632548,16632487,122
4815,3482816,3,17857216,17857359,17857287,143
4816,3482816,3,18816266,18817390,18816828,1124
4817,3482816,3,19576289,19577097,19576693,808
4818,3482816,3,23267472,23268267,23267869,795
4819,3482816,4,17509622,17509736,17509679,114
4820,3482816,5,26684542,26685606,26685074,1064
4821,3482820,1,10173931,10173948,10173939,17
4822,3482820,1,19141573,19141645,19141609,72
4823,3482820,2,1533486,1534249,1533867,763
4824,3482820,3,3465198,3465715,3465456,517
4825,3482820,3,22938525,22940220,22939372,1695
4826,3482820,4,6415802,6416162,6415982,360
4827,3482820,5,8780967,8781505,8781236,538
4828,3482821,1,9977734,9978508,9978121,774
4829,3482821,2,97056,97774,97415,718
4830,3482821,2,16563337,16564796,16564066,1459
4831,3482821,3,4035421,4035850,4035635,429
4832,3482822,1,13454444,13455375,13454909,931
4833,3482822,2,393665,395977,394821,2312
4834,3482822,2,9963785,9964761,9964273,976
4835,3482822,3,3933882,3934162,3934022,280
4836,3482822,3,18288531,18288962,18288746,431
4837,3482822,4,10964326,10964490,10964408,164
4838,3482822,4,16651911,16651966,16651938,55
4839,3482822,5,7052690,7052708,7052699,18
4840,3482822,5,22313701,22313837,22313769,136
4841,3482822,5,24646359,24646693,24646526,334
4842,3482823,1,17283163,17283448,17283305,285
4843,3482823,1,24797087,24797268,24797177,181
4844,3482823,2,489883,490824,490353,941
4845,3482823,2,17975081,17975316,17975198,235
4846,3482823,3,581304,581400,581352,96
4847,3482823,3,16371229,16371296,16371262,67
4848,3482823,3,21877168,21879409,21878288,2241
4849,3482823,4,6449300,6449309,6449304,9
4850,3482823,5,22443463,22443667,22443565,204
4851,3482823,5,26013320,26013618,26013469,298
4852,3482824,1,17232062,17238362,17235212,6300
4853,3482824,1,26357974,26358208,26358091,234
4854,3482824,3,8107448,8108472,8107960,1024
4855,3482824,5,16829955,16830961,16830458,1006
4856,3482824,5,22214611,22215186,22214898,575
4857,3482825,3,19726174,19726705,19726439,531
4858,3482825,4,7764449,7765140,7764794,691
4859,3482825,5,7327475,7330676,7329075,3201
4860,3482825,5,9598826,9598897,9598861,71
4861,3482826,1,6251331,6251675,6251503,344
4862,3482826,2,7085070,7086280,7085675,1210
4863,3482826,2,16707574,16709531,16708552,1957
4864,3482826,3,9567650,9567758,9567704,108
4865,3482826,4,179908,180064,179986,156
4866,3482826,4,5759511,5759526,5759518,15
4867,3482826,5,13938064,13938345,13938204,281
4868,3482826,5,16648864,16650004,16649434,1140
4869,3482827,1,9511563,9511669,9511616,106
4870,3482827,1,24644961,24646511,24645736,1550
4871,3482827,2,1491084,1491614,1491349,530
4872,3482827,3,14764190,14764379,14764284,189
4873,3482827,4,10775172,10775428,10775300,256
4874,3482827,5,15374801,15374985,15374893,184
4875,3482828,1,6475123,6475464,6475293,341
4876,3482828,2,16063501,16064090,16063795,589
4877,3482828,3,18302585,18302824,18302704,239
4878,3482828,4,319551,319844,319697,293
4879,3482828,4,794324,794923,794623,599
4880,3482828,4,11174417,11174558,11174487,141
4881,3482828,5,3843532,3845035,3844283,1503
4882,3482828,5,5833749,5834044,5833896,295
4883,3482829,1,9926518,9927561,9927039,1043
4884,3482829,1,17760247,17764809,17762528,4562
4885,3482829,2,6788816,6789105,6788960,289
4886,3482829,2,16530300,16533611,16531955,3311
4887,3482829,3,1108458,1111386,1109922,2928
4888,3482829,3,16522649,16522697,16522673,48
4889,3482829,3,19481551,19482966,19482258,1415
4890,3482829,4,423249,423296,423272,47
4891,3482829,4,8079219,8080353,8079786,1134
4892,3482829,5,8392058,8392809,8392433,751
4893,3482829,5,15059893,15059906,15059899,13
4894,3482829,5,25487175,25487241,25487208,66
4895,3482830,1,267352,267588,267470,236
4896,3482830,1,13655792,13655800,13655796,8
4897,3482830,1,22302840,22302984,22302912,144
4898,3482830,1,26702632,26702715,26702673,83
4899,3482830,2,5532437,5534827,5533632,2390
4900,3482830,3,10989978,10991965,10990971,1987
4901,3482830,3,20784446,20785358,20784902,912
4902,3482830,5,536393,536445,536419,52
4903,3482830,5,26512643,26513624,26513133,981
4904,3482831,1,5385117,5385532,5385324,415
4905,3482831,1,12479124,12479892,12479508,768
4906,3482831,1,13172411,13172465,13172438,54
4907,3482831,1,24356901,24357255,24357078,354
4908,3482831,2,1056645,1056896,1056770,251
4909,3482831,2,13944769,13945171,13944970,402
4910,3482831,3,22382309,22384117,22383213,1808
4911,3482831,4,10572211,10572298,10572254,87
4912,3482831,5,9458251,9459538,9458894,1287
4913,3482831,5,17151071,17152599,17151835,1528
4914,3482832,1,12361872,12361971,12361921,99
4915,3482832,1,26871379,26872747,26872063,1368
4916,3482832,1,27443181,27443349,27443265,168
4917,3482832,2,687415,687449,687432,34
4918,3482832,3,4873567,4873876,4873721,309
4919,3482832,3,6041263,6041518,6041390,255
4920,3482832,3,7941928,7941977,7941952,49
4921,3482832,4,17320507,17320512,17320509,5
4922,3482832,5,98211,99032,98621,821
4923,3482832,5,3256475,3256962,3256718,487
4924,3482832,5,3845035,3845509,3845272,474
4925,3482832,5,8738734,8739242,8738988,508
4926,3482832,5,26645772,26645986,26645879,214
4927,3482833,2,6016878,6017200,6017039,322
4928,3482833,2,12527199,12527681,12527440,482
4929,3482833,3,16541702,16541816,16541759,114
4930,3482833,3,17239591,17240075,17239833,484
4931,3482833,4,5737163,5737178,5737170,15
4932,3482833,5,17882582,17883489,17883035,907
4933,3482834,1,1215837,1216558,1216197,721
4934,3482834,1,12167560,12167611,12167585,51
4935,3482834,1,17203068,17203093,17203080,25
4936,3482834,1,29489988,29490503,29490245,515
4937,3482834,2,7308290,7308767,7308528,477
4938,3482834,2,11665917,11666827,11666372,910
4939,3482834,3,19531128,19532517,19531822,1389
4940,3482834,5,16489860,16490119,16489989,259
4941,3482834,5,26214607,26215675,26215141,1068
4942,3482835,2,1031226,1031470,1031348,244
4943,3482835,3,3898641,3899309,3898975,668
4944,3482835,3,10411813,10411931,10411872,118
4945,3482835,3,17866635,17867164,17866899,529
4946,3482835,4,13357989,13358536,13358262,547
4947,3482836,1,21193478,21193927,21193702,449
4948,3482836,2,9376888,9378454,9377671,1566
4949,3482836,3,6218858,6219048,6218953,190
4950,3482836,4,5297088,5297446,5297267,358
4951,3482836,4,15992047,15992359,15992203,312
4952,3482837,1,17252716,17253368,17253042,652
4953,3482837,1,26000069,26000437,26000253,368
4954,3482837,2,676809,676812,676810,3
4955,3482837,3,5487514,5488961,5488237,1447
4956,3482837,5,6663576,6667698,6665637,4122
4957,3482837,5,8580851,8581408,8581129,557
4958,3482838,1,19571500,19571571,19571535,71
4959,3482838,2,16926230,16926327,16926278,97
4960,3482838,3,18997754,18997831,18997792,77
4961,3482838,3,21942527,21942737,21942632,210
4962,3482838,4,9752298,9753887,9753092,1589
4963,3482838,5,4002951,4002971,4002961,20
4964,3482838,5,23947052,23947361,23947206,309
4965,3482839,1,9231199,9231267,9231233,68
4966,3482839,1,13872297,13872375,13872336,78
4967,3482839,1,16141475,16141666,16141570,191
4968,3482839,2,13607542,13608407,13607974,865
4969,3482839,3,9837876,9838140,9838008,264
4970,3482839,3,16644025,16647872,16645948,3847
4971,3482839,4,9834988,9835414,9835201,426
4972,3482839,5,15363025,15363847,15363436,822
4973,3482840,1,2506361,2507106,2506733,745
4974,3482840,1,20180080,20182147,20181113,2067
4975,3482840,1,29437671,29437734,29437702,63
4976,3482840,2,6292051,6292131,6292091,80
4977,3482840,2,18273807,18273814,18273810,7
4978,3482840,3,5657829,5658143,5657986,314
4979,3482840,3,18758117,18758191,18758154,74
4980,3482840,4,655654,657521,656587,1867
4981,3482840,4,6411975,6412508,6412241,533
4982,3482840,4,17464593,17464843,17464718,250
4983,3482840,5,14955338,14957840,14956589,2502
4984,3482840,5,22129095,22129581,22129338,486
4985,3482840,5,25884235,25884388,25884311,153
4986,3482841,1,13431043,13431462,13431252,419
4987,3482841,2,368988,371063,370025,2075
4988,3482841,2,9904076,9904715,9904395,639
4989,3482841,3,3924408,3925314,3924861,906
4990,3482841,3,18301651,18302582,18302116,931
4991,3482841,4,10963373,10963384,10963378,11
4992,3482841,4,16648528,16649432,16648980,904
4993,3482841,5,7049371,7049407,7049389,36
4994,3482841,5,22314911,22315218,22315064,307
4995,3482841,5,24647575,24647802,24647688,227
4996,3482842,1,11854286,11854468,11854377,182
4997,3482842,1,20042014,20043494,20042754,1480
4998,3482842,2,1566820,1566972,1566896,152
4999,3482842,3,7622162,7622354,7622258,192
5000,3482842,3,9283605,9283699,9283652,94
5001,3482842,4,7751300,7751388,7751344,88
5002,3482843,1,16645848,16645949,16645898,101
5003,3482843,2,6764155,6764214,6764184,59
5004,3482843,3,1344991,1345335,1345163,344
5005,3482843,3,7346835,7347139,7346987,304
5006,3482843,4,6863710,6863905,6863807,195
5007,3482843,4,16321986,16321995,16321990,9
5008,3482843,5,19107343,19107372,19107357,29
5009,3482843,5,21319413,21319426,21319419,13
5010,3482844,1,8202967,8203237,8203102,270
5011,3482844,2,19055541,19057077,19056309,1536
5012,3482844,3,602888,603673,603280,785
5013,3482844,3,3141549,3142048,3141798,499
5014,3482844,3,18730692,18731174,18730933,482
5015,3482844,4,15412783,15412896,15412839,113
5016,3482844,5,942059,943871,942965,1812
5017,3482844,5,6233304,6233517,6233410,213
5018,3482844,5,8654508,8654555,8654531,47
5019,3482844,5,20004426,20005719,20005072,1293
5020,3482845,1,7513307,7514090,7513698,783
5021,3482845,1,8158056,8158062,8158059,6
5022,3482845,1,26582235,26583690,26582962,1455
5023,3482845,2,8702172,8704050,8703111,1878
5024,3482845,3,7640422,7640651,7640536,229
5025,3482845,4,5750513,5750815,5750664,302
5026,3482845,4,17719325,17721024,17720174,1699
5027,3482845,5,21736517,21736606,21736561,89
5028,3482846,1,24773717,24774392,24774054,675
5029,3482846,3,17609965,17609991,17609978,26
5030,3482846,4,6103360,6103424,6103392,64
5031,3482846,4,8980692,8980943,8980817,251
5032,3482846,5,8594517,8594592,8594554,75
5033,3482847,1,8910712,8910785,8910748,73
5034,3482847,3,21893034,21893290,21893162,256
5035,3482847,4,1039951,1040043,1039997,92
5036,3482847,5,1257739,1257786,1257762,47
5037,3482847,5,9671516,9672346,9671931,830
5038,3482847,5,14863600,14863891,14863745,291
5039,3482847,5,22390175,22390213,22390194,38
5040,3482848,1,4065249,4065846,4065547,597
5041,3482848,1,24165789,24165979,24165884,190
5042,3482848,1,28305191,28305302,28305246,111
5043,3482848,1,28918510,28919006,28918758,496
5044,3482848,2,1297272,1297296,1297284,24
5045,3482848,2,13165147,13165403,13165275,256
5046,3482848,3,1051358,1054190,1052774,2832
5047,3482848,3,17609562,17609928,17609745,366
5048,3482848,4,5932392,5938875,5935633,6483
5049,3482848,4,18537816,18538807,18538311,991
5050,3482848,5,10506888,10506964,10506926,76
5051,3482848,5,22049492,22049715,22049603,223
5052,3482849,1,4743412,4744225,4743818,813
5053,3482849,2,8978782,8979360,8979071,578
5054,3482849,2,13104447,13104846,13104646,399
5055,3482849,3,19500011,19502156,19501083,2145
5056,3482850,1,17695111,17695385,17695248,274
5057,3482850,1,29497828,29497847,29497837,19
5058,3482850,2,100462,100543,100502,81
5059,3482850,2,2180734,2181177,2180955,443
5060,3482850,2,12832343,12832510,12832426,167
5061,3482850,5,9521187,9521576,9521381,389
5062,3482850,5,16444642,16446561,16445601,1919
5063,3482850,5,21883211,21883259,21883235,48
5064,3482851,1,3452192,3453547,3452869,1355
5065,3482851,1,26115698,26116288,26115993,590
5066,3482851,1,29544127,29544243,29544185,116
5067,3482851,2,10237148,10237766,10237457,618
5068,3482851,2,18828252,18828428,18828340,176
5069,3482851,3,8759400,8759427,8759413,27
5070,3482851,3,19473979,19476163,19475071,2184
5071,3482851,4,8059588,8060244,8059916,656
5072,3482851,5,4115552,4116142,4115847,590
5073,3482851,5,19184758,19184833,19184795,75
5074,3482852,1,6656531,6656790,6656660,259
5075,3482852,1,19487247,19487841,19487544,594
5076,3482852,2,2267071,2267891,2267481,820
5077,3482852,3,8286460,8287594,8287027,1134
5078,3482852,3,16847999,16848050,16848024,51
5079,3482852,5,21662002,21662157,21662079,155
5080,3482853,1,27537922,27539971,27538946,2049
5081,3482853,2,1494546,1494643,1494594,97
5082,3482853,2,12543417,12543990,12543703,573
5083,3482853,3,1687957,1688133,1688045,176
5084,3482853,3,9419385,9419533,9419459,148
5085,3482853,4,675995,676060,676027,65
5086,3482853,4,13093506,13093570,13093538,64
5087,3482853,5,1018970,1018989,1018979,19
5088,3482853,5,15996398,15996685,15996541,287
5089,3482853,5,25841469,25841872,25841670,403
5090,3482854,1,7792098,7792709,7792403,611
5091,3482854,1,9257334,9260823,9259078,3489
5092,3482854,1,29486423,29487900,29487161,1477
5093,3482854,2,7332268,7332282,7332275,14
5094,3482854,2,15011517,15011849,15011683,332
5095,3482854,3,18690897,18691025,18690961,128
5096,3482854,5,18733987,18735284,18734635,1297
5097,3482854,5,26080917,26081275,26081096,358
5098,3482855,1,18998995,19000316,18999655,1321
5099,3482855,2,1035827,1036820,1036323,993
5100,3482855,3,11263016,11263039,11263027,23
5101,3482855,4,6221196,6221271,6221233,75
5102,3482855,5,24645432,24646065,24645748,633
5103,3482856,1,9180689,9181319,9181004,630
5104,3482856,1,9968887,9969150,9969018,263
5105,3482856,2,17959844,17964240,17962042,4396
5106,3482856,4,7999218,7999896,7999557,678
5107,3482856,5,26019725,26019860,26019792,135
5108,3482857,1,2529577,2531374,2530475,1797
5109,3482857,1,10866324,10867617,10866970,1293
5110,3482857,1,12607954,12608114,12608034,160
5111,3482857,2,6914457,6914609,6914533,152
5112,3482857,2,9878527,9878536,9878531,9
5113,3482857,3,4130564,4130843,4130703,279
5114,3482857,3,22239180,22239585,22239382,405
5115,3482857,5,2341830,2346101,2343965,4271
5116,3482857,5,8689070,8690240,8689655,1170
5117,3482858,1,11202825,11202892,11202858,67
5118,3482858,1,17214562,17215084,17214823,522
5119,3482858,2,19292960,19293566,19293263,606
5120,3482858,4,11750773,11752933,11751853,2160
5121,3482858,4,15619240,15619664,15619452,424
5122,3482858,5,8292781,8292955,8292868,174
5123,3482858,5,13424411,13425740,13425075,1329
5124,3482858,5,26516154,26516401,26516277,247
5125,3482859,1,9800316,9800852,9800584,536
5126,3482859,1,25745901,25745926,25745913,25
5127,3482859,3,3693833,3693909,3693871,76
5128,3482859,5,1459813,1460947,1460380,1134
5129,3482859,5,14951698,14952041,14951869,343
5130,3482860,1,3932938,3933012,3932975,74
5131,3482860,1,10580385,10580542,10580463,157
5132,3482860,1,23011553,23015565,23013559,4012
5133,3482860,2,6016848,6016872,6016860,24
5134,3482860,2,13037942,13038066,13038004,124
5135,3482860,3,9802078,9802973,9802525,895
5136,3482860,4,5710505,5710519,5710512,14
5137,3482860,4,12508763,12509296,12509029,533
5138,3482861,1,26530648,26531838,26531243,1190
5139,3482861,2,12610516,12611065,12610790,549
5140,3482861,4,390127,390891,390509,764
5141,3482861,4,9367173,9369527,9368350,2354
5142,3482861,5,6032468,6032900,6032684,432
5143,3482861,5,22332082,22332103,22332092,21
5144,3482862,1,1895438,1896428,1895933,990
5145,3482862,5,13684579,13684821,13684700,242
5146,3482862,5,18808700,18808808,18808754,108
5147,3482862,5,24159911,24161555,24160733,1644
5148,3482863,1,4222466,4222519,4222492,53
5149,3482863,1,8075699,8075958,8075828,259
5150,3482863,1,16972186,16972385,16972285,199
5151,3482863,2,111569,111699,111634,130
5152,3482863,2,2087623,2089521,2088572,1898
5153,3482863,2,18138914,18142609,18140761,3695
5154,3482863,3,1606050,1606334,1606192,284
5155,3482863,3,10176851,10178151,10177501,1300
5156,3482863,4,891994,892609,892301,615
5157,3482863,4,4800274,4800812,4800543,538
5158,3482863,5,6336466,6337945,6337205,1479
5159,3482864,1,6677919,6678549,6678234,630
5160,3482864,1,20102777,20102843,20102810,66
5161,3482864,2,882115,888955,885535,6840
5162,3482864,2,10191940,10193183,10192561,1243
5163,3482864,2,16752864,16752921,16752892,57
5164,3482864,3,9637650,9637712,9637681,62
5165,3482864,3,18808967,18809125,18809046,158
5166,3482864,4,5451665,5453025,5452345,1360
5167,3482864,5,8220885,8223901,8222393,3016
5168,3482864,5,14721382,14722118,14721750,736
5169,3482865,1,7892149,7892218,7892183,69
5170,3482865,1,17019428,17019507,17019467,79
5171,3482865,1,23692467,23692913,23692690,446
5172,3482865,2,1601760,1602342,1602051,582
5173,3482865,2,18360635,18361272,18360953,637
5174,3482865,3,7616965,7617844,7617404,879
5175,3482865,5,21692953,21692990,21692971,37
5176,3482865,5,26029782,26030056,26029919,274
5177,3482866,1,451311,452718,452014,1407
5178,3482866,1,10033245,10033318,10033281,73
5179,3482866,1,20723929,20724061,20723995,132
5180,3482866,1,24632225,24632979,24632602,754
5181,3482866,2,1917516,1917601,1917558,85
5182,3482866,3,3470531,3471679,3471105,1148
5183,3482866,3,6667332,6668977,6668154,1645
5184,3482866,3,10798029,10798574,10798301,545
5185,3482866,4,9719586,9720397,9719991,811
5186,3482866,5,5842536,5843839,5843187,1303
5187,3482866,5,16299690,16300435,16300062,745
5188,3482866,5,16766192,16767676,16766934,1484
5189,3482870,1,12922179,12922231,12922205,52
5190,3482870,2,1881806,1881854,1881830,48
5191,3482870,2,6915726,6915790,6915758,64
5192,3482870,2,17968769,17969507,17969138,738
5193,3482870,3,7612478,7613113,7612795,635
5194,3482870,3,19452777,19453048,19452912,271
5195,3482870,4,7568900,7569256,7569078,356
5196,3482870,4,15593956,15594066,15594011,110
5197,3482871,2,1696398,1697258,1696828,860
5198,3482871,2,18588647,18589678,18589162,1031
5199,3482871,3,1838584,1838853,1838718,269
5200,3482871,4,644179,644758,644468,579
5201,3482871,4,11507078,11508623,11507850,1545
5202,3482871,4,14451787,14455355,14453571,3568
5203,3482871,5,10263458,10263540,10263499,82
5204,3482871,5,15929991,15931770,15930880,1779
5205,3482872,1,2283085,2284235,2283660,1150
5206,3482872,1,11861380,11861430,11861405,50
5207,3482872,2,9431991,9432376,9432183,385
5208,3482872,2,18746722,18747173,18746947,451
5209,3482872,3,323058,323525,323291,467
5210,3482872,3,17862328,17862398,17862363,70
5211,3482872,4,5660360,5660556,5660458,196
5212,3482872,4,18138528,18139194,18138861,666
5213,3482872,5,8563740,8565499,8564619,1759
5214,3482872,5,18800792,18800912,18800852,120
5215,3482872,5,26515178,26515905,26515541,727
5216,3482873,1,6171982,6171991,6171986,9
5217,3482873,1,26630636,26630693,26630664,57
5218,3482873,2,13802154,13802340,13802247,186
5219,3482873,3,3990792,3991379,3991085,587
5220,3482873,3,16629181,16629283,16629232,102
5221,3482873,4,528997,529062,529029,65
5222,3482873,4,1251820,1252017,1251918,197
5223,3482873,5,446209,446495,446352,286
5224,3482873,5,19098537,19098667,19098602,130
5225,3482874,1,30411919,30411997,30411958,78
5226,3482874,2,6613568,6613918,6613743,350
5227,3482874,3,15655904,15656201,15656052,297
5228,3482874,4,7318538,7318570,7318554,32
5229,3482874,4,9261272,9261360,9261316,88
5230,3482875,1,7310695,7311159,7310927,464
5231,3482875,1,28207638,28209042,28208340,1404
5232,3482875,2,10100723,10102254,10101488,1531
5233,3482875,2,18169172,18169448,18169310,276
5234,3482875,3,22410075,22410865,22410470,790
5235,3482875,5,6845012,6847192,6846102,2180
5236,3482875,5,18616887,18617325,18617106,438
5237,3482876,1,9883359,9883410,9883384,51
5238,3482876,1,23275041,23275122,23275081,81
5239,3482876,1,30243683,30243847,30243765,164
5240,3482876,2,9327873,9328093,9327983,220
5241,3482876,2,19393340,19393559,19393449,219
5242,3482876,3,9311270,9311869,9311569,599
5243,3482876,3,23196005,23196027,23196016,22
5244,3482876,4,6323646,6323672,6323659,26
5245,3482876,5,16827675,16827815,16827745,140
5246,3482877,1,2666315,2667078,2666696,763
5247,3482877,1,10711225,10711732,10711478,507
5248,3482877,1,30417499,30417616,30417557,117
5249,3482877,2,180621,181007,180814,386
5250,3482877,2,1426572,1427027,1426799,455
5251,3482877,3,3028910,3029642,3029276,732
5252,3482877,4,15755539,15756418,15755978,879
5253,3482877,5,17168060,17168115,17168087,55
5254,3482877,5,19305455,19307252,19306353,1797
5255,3482877,5,24787797,24787837,24787817,40
5256,3482878,1,8036073,8036136,8036104,63
5257,3482878,1,26106088,26109854,26107971,3766
5258,3482878,2,611833,612081,611957,248
5259,3482878,2,10773142,10774244,10773693,1102
5260,3482878,2,19467282,19467472,19467377,190
5261,3482878,3,10222359,10222400,10222379,41
5262,3482878,4,394275,394640,394457,365
5263,3482878,5,7066108,7066130,7066119,22
5264,3482878,5,24406996,24407273,24407134,277
5265,3482879,1,8937260,8939231,8938245,1971
5266,3482879,1,23479572,23480151,23479861,579
5267,3482879,2,1540585,1540623,1540604,38
5268,3482879,2,12006181,12007682,12006931,1501
5269,3482879,3,9181711,9182257,9181984,546
5270,3482879,3,11368576,11368870,11368723,294
5271,3482879,3,22315143,22315347,22315245,204
5272,3482879,5,10214569,10214637,10214603,68
5273,3482879,5,25834407,25834939,25834673,532
5274,3482880,1,387776,387895,387835,119
5275,3482880,1,1074146,1076505,1075325,2359
5276,3482880,1,25232405,25232429,25232417,24
5277,3482880,2,9996444,9996685,9996564,241
5278,3482880,3,10738478,10738583,10738530,105
5279,3482880,4,9001160,9002330,9001745,1170
5280,3482880,5,2385331,2385487,2385409,156
5281,3482880,5,13867572,13868967,13868269,1395
5282,3482881,1,10328338,10328511,10328424,173
5283,3482881,2,10193943,10194269,10194106,326
5284,3482881,3,1058633,1058793,1058713,160
5285,3482881,3,10154285,10154529,10154407,244
5286,3482881,3,22104080,22104507,22104293,427
5287,3482881,4,10363766,10364749,10364257,983
5288,3482881,5,934915,936893,935904,1978
5289,3482881,5,15621230,15621643,15621436,413
5290,3482881,5,23206937,23214138,23210537,7201
5291,3482881,5,26573967,26574121,26574044,154
5292,3482885,1,8926962,8927325,8927143,363
5293,3482885,1,29696847,29698080,29697463,1233
5294,3482885,2,6291975,6292051,6292013,76
5295,3482885,4,11177513,11178577,11178045,1064
5296,3482885,5,9305220,9305390,9305305,170
5297,3482885,5,17988615,17988696,17988655,81
5298,3482886,1,2619209,2624102,2621655,4893
5299,3482886,2,728088,728266,728177,178
5300,3482886,2,6503905,6504475,6504190,570
5301,3482886,2,18842308,18845891,18844099,3583
5302,3482886,3,884712,884989,884850,277
5303,3482886,3,11258452,11259766,11259109,1314
5304,3482886,3,19935900,19935989,19935944,89
5305,3482886,4,11939412,11939573,11939492,161
5306,3482887,1,27171620,27171700,27171660,80
5307,3482887,2,742961,744854,743907,1893
5308,3482887,2,2090324,2090394,2090359,70
5309,3482887,3,311901,311978,311939,77
5310,3482887,3,16920218,16920472,16920345,254
5311,3482887,4,11519729,11521774,11520751,2045
5312,3482887,5,3529393,3530546,3529969,1153
5313,3482887,5,9474915,9475913,9475414,998
5314,3482887,5,19944422,19945720,19945071,1298
5315,3482888,1,6320364,6321932,6321148,1568
5316,3482888,1,22164520,22164704,22164612,184
5317,3482888,2,11313306,11313414,11313360,108
5318,3482888,4,6354601,6354696,6354648,95
5319,3482888,4,6832334,6832436,6832385,102
5320,3482888,5,21592104,21592602,21592353,498
5321,3482889,1,10891534,10891812,10891673,278
5322,3482889,2,1553750,1554358,1554054,608
5323,3482889,2,7892731,7893183,7892957,452
5324,3482889,2,16336981,16338309,16337645,1328
5325,3482889,3,18959753,18960323,18960038,570
5326,3482889,3,20299067,20300032,20299549,965
5327,3482889,4,1252017,1252871,1252444,854
5328,3482889,4,18453246,18454334,18453790,1088
5329,3482889,5,2497768,2499201,2498484,1433
5330,3482889,5,21718173,21718430,21718301,257
5331,3482889,5,25000794,25002166,25001480,1372
5332,3482890,3,19182056,19182238,19182147,182
5333,3482890,4,173542,173598,173570,56
5334,3482890,4,7308931,7309779,7309355,848
5335,3482890,4,17807234,17813689,17810461,6455
5336,3482890,5,7935066,7935663,7935364,597
5337,3482890,5,25436891,25437340,25437115,449
5338,3482891,1,13141652,13141654,13141653,2
5339,3482891,1,29784304,29784538,29784421,234
5340,3482891,2,12423445,12424612,12424028,1167
5341,3482891,3,9361950,9362050,9362000,100
5342,3482892,2,7051107,7052256,7051681,1149
5343,3482892,3,11499378,11499500,11499439,122
5344,3482892,4,7461544,7462068,7461806,524
5345,3482892,5,10792898,10796752,10794825,3854
5346,3482893,1,23866751,23867269,23867010,518
5347,3482893,1,26371427,26371449,26371438,22
5348,3482893,2,6212720,6213185,6212952,465
5349,3482893,3,18657723,18657816,18657769,93
5350,3482893,4,464342,465410,464876,1068
5351,3482893,4,6153173,6154896,6154034,1723
5352,3482893,4,11147342,11147626,11147484,284
5353,3482893,5,6399628,6400379,6400003,751
5354,3482893,5,25584910,25585132,25585021,222
5355,3482894,1,5853601,5854281,5853941,680
5356,3482894,1,19442247,19442316,19442281,69
5357,3482894,1,26979426,26980082,26979754,656
5358,3482894,2,1024894,1025025,1024959,131
5359,3482894,2,15438312,15439974,15439143,1662
5360,3482894,3,10079683,10079814,10079748,131
5361,3482894,3,21357948,21359697,21358822,1749
5362,3482894,4,13874339,13874414,13874376,75
5363,3482894,5,13933706,13933781,13933743,75
5364,3482895,1,6938916,6939247,6939081,331
5365,3482895,1,8864629,8864944,8864786,315
5366,3482895,1,21173565,21173680,21173622,115
5367,3482895,2,2243797,2243882,2243839,85
5368,3482895,3,11741081,11744206,11742643,3125
5369,3482895,4,5151873,5152139,5152006,266
5370,3482895,4,7662445,7662836,7662640,391
5371,3482895,5,566313,568761,567537,2448
5372,3482895,5,20213032,20213474,20213253,442
5373,3482896,1,267613,267853,267733,240
5374,3482896,1,12934733,12934773,12934753,40
5375,3482896,1,28511792,28512067,28511929,275
5376,3482896,2,12395421,12395599,12395510,178
5377,3482896,4,10591056,10591341,10591198,285
5378,3482896,4,14207151,14208207,14207679,1056
5379,3482896,4,15974772,15975730,15975251,958
5380,3482897,1,3829580,3829636,3829608,56
5381,3482897,1,19835698,19835774,19835736,76
5382,3482897,1,23391464,23391475,23391469,11
5383,3482897,2,660324,660952,660638,628
5384,3482897,2,11997386,11997586,11997486,200
5385,3482897,4,16188880,16190929,16189904,2049
5386,3482897,4,16819385,16819432,16819408,47
5387,3482897,5,7278231,7279006,7278618,775
5388,3482898,1,18193757,18193818,18193787,61
5389,3482898,2,11884731,11886496,11885613,1765
5390,3482898,3,22176452,22176959,22176705,507
5391,3482898,4,15282950,15283796,15283373,846
5392,3482898,5,24922993,24923905,24923449,912
5393,3482899,1,8187410,8187467,8187438,57
5394,3482899,2,1682069,1682530,1682299,461
5395,3482899,2,8895405,8896135,8895770,730
5396,3482899,4,12458735,12458893,12458814,158
5397,3482899,5,3316988,3317048,3317018,60
5398,3482899,5,15850605,15850679,15850642,74
5399,3482900,1,3237339,3237452,3237395,113
5400,3482900,2,9462223,9463055,9462639,832
5401,3482900,3,5797469,5798269,5797869,800
5402,3482900,4,5834924,5835200,5835062,276
5403,3482900,4,12694818,12695827,12695322,1009
5404,3482900,5,10394750,10397070,10395910,2320
5405,3482900,5,20490641,20490752,20490696,111
5406,3482900,5,21392427,21392773,21392600,346
5407,3482901,1,11587809,11588139,11587974,330
5408,3482901,5,9878620,9879511,9879065,891
5409,3482901,5,22728104,22734172,22731138,6068
5410,3482903,1,11257325,11257519,11257422,194
5411,3482903,1,11824455,11824869,11824662,414
5412,3482903,1,25374097,25374453,25374275,356
5413,3482903,2,19070828,19073911,19072369,3083
5414,3482903,3,15668624,15668809,15668716,185
5415,3482903,3,17100417,17100424,17100420,7
5416,3482903,4,5804731,5804885,5804808,154
5417,3482903,4,7226613,7226722,7226667,109
5418,3482904,1,28254972,28256313,28255642,1341
5419,3482904,2,9798468,9798554,9798511,86
5420,3482904,4,13822,15364,14593,1542
5421,3482904,4,14108886,14111900,14110393,3014
5422,3482904,4,18041956,18043359,18042657,1403
5423,3482904,5,7729108,7729801,7729454,693
5424,3482905,1,10598629,10598962,10598795,333
5425,3482905,1,16872461,16873975,16873218,1514
5426,3482905,1,21404291,21404319,21404305,28
5427,3482905,2,6299320,6299986,6299653,666
5428,3482905,3,4615553,4615848,4615700,295
5429,3482905,3,8536913,8536957,8536935,44
5430,3482905,4,436140,441710,438925,5570
5431,3482905,5,1960723,1960744,1960733,21
5432,3482905,5,3503537,3505204,3504370,1667
5433,3482905,5,16163783,16164113,16163948,330
5434,3482905,5,26515206,26515551,26515378,345
5435,3482906,1,8003746,8003888,8003817,142
5436,3482906,1,16422866,16424371,16423618,1505
5437,3482906,1,30277548,30278168,30277858,620
5438,3482906,3,10714105,10714277,10714191,172
5439,3482906,4,6073842,6073973,6073907,131
5440,3482906,5,1149883,1150505,1150194,622
5441,3482906,5,18045107,18045464,18045285,357
5442,3482907,1,19537105,19537477,19537291,372
5443,3482907,2,9613364,9613716,9613540,352
5444,3482907,3,4395317,4395507,4395412,190
5445,3482907,3,16952631,16952967,16952799,336
5446,3482910,1,11961549,11961708,11961628,159
5447,3482910,1,17294596,17294852,17294724,256
5448,3482910,2,744936,745019,744977,83
5449,3482910,3,5002732,5003132,5002932,400
5450,3482910,4,10145641,10146180,10145910,539
5451,3482910,5,978905,979037,978971,132
5452,3482910,5,7980019,7980073,7980046,54
5453,3482910,5,8951234,8951704,8951469,470
5454,3482910,5,16621916,16621939,16621927,23
5455,3482911,1,3716128,3716278,3716203,150
5456,3482911,1,13304625,13304942,13304783,317
5457,3482911,1,19831848,19832907,19832377,1059
5458,3482911,2,7527140,7527663,7527401,523
5459,3482911,2,12850474,12850570,12850522,96
5460,3482911,2,15097837,15098054,15097945,217
5461,3482911,3,421673,421855,421764,182
5462,3482911,4,491006,491015,491010,9
5463,3482911,4,15221418,15221519,15221468,101
5464,3482911,5,7190062,7191119,7190590,1057
5465,3482911,5,25040901,25042702,25041801,1801
5466,3482912,1,1530914,1531779,1531346,865
5467,3482912,1,22185283,22185424,22185353,141
5468,3482912,2,1640591,1640655,1640623,64
5469,3482912,2,8378072,8378801,8378436,729
5470,3482912,3,1276393,1277331,1276862,938
5471,3482912,3,10983486,10983517,10983501,31
5472,3482912,3,15657615,15657809,15657712,194
5473,3482912,4,9150293,9150968,9150630,675
5474,3482912,5,1282985,1283057,1283021,72
5475,3482912,5,9363843,9365078,9364460,1235
5476,3482912,5,17609173,17609238,17609205,65
5477,3482912,5,26034199,26034238,26034218,39
5478,3482913,1,20778092,20778140,20778116,48
5479,3482913,1,26803191,26804018,26803604,827
5480,3482913,2,86107,86609,86358,502
5481,3482913,3,9605043,9605727,9605385,684
5482,3482914,1,17420371,17427047,17423709,6676
5483,3482914,3,9500350,9500885,9500617,535
5484,3482914,3,15656384,15656893,15656638,509
5485,3482914,4,6177662,6177732,6177697,70
5486,3482914,5,13770638,13770925,13770781,287
5487,3482915,1,769557,770064,769810,507
5488,3482915,1,7482240,7482985,7482612,745
5489,3482915,1,11838865,11839748,11839306,883
5490,3482915,1,28212222,28212407,28212314,185
5491,3482915,2,540709,540774,540741,65
5492,3482915,2,6642182,6642844,6642513,662
5493,3482915,3,3428305,3428648,3428476,343
5494,3482915,3,16154040,16154175,16154107,135
5495,3482915,4,4850351,4851521,4850936,1170
5496,3482915,5,934249,934411,934330,162
5497,3482915,5,4835234,4836797,4836015,1563
5498,3482916,1,4193460,4193681,4193570,221
5499,3482916,1,8378987,8379694,8379340,707
5500,3482916,1,12711885,12712412,12712148,527
5501,3482916,1,18431639,18431691,18431665,52
5502,3482916,1,19366940,19367682,19367311,742
5503,3482916,1,25340788,25340872,25340830,84
5504,3482916,2,7040243,7040438,7040340,195
5505,3482916,2,7676130,7676641,7676385,511
5506,3482916,2,13915360,13916242,13915801,882
5507,3482916,3,9529499,9530196,9529847,697
5508,3482916,4,1285162,1285406,1285284,244
5509,3482916,5,23809948,23810240,23810094,292
5510,3482916,5,26741794,26741815,26741804,21
5511,3482917,1,12687094,12687537,12687315,443
5512,3482917,1,19687940,19688034,19687987,94
5513,3482917,3,4987373,4988187,4987780,814
5514,3482917,3,9136552,9136621,9136586,69
5515,3482917,3,21041900,21042731,21042315,831
5516,3482917,4,1252017,1253047,1252532,1030
5517,3482917,4,10663998,10664073,10664035,75
5518,3482917,5,2111911,2112316,2112113,405
5519,3482917,5,15188879,15189141,15189010,262
5520,3482917,5,26056326,26056588,26056457,262
5521,3482918,1,10366489,10366827,10366658,338
5522,3482918,1,21243143,21243290,21243216,147
5523,3482918,1,23854722,23854879,23854800,157
5524,3482918,1,24368797,24368836,24368816,39
5525,3482918,3,8079409,8079795,8079602,386
5526,3482918,3,18999512,18999922,18999717,410
5527,3482918,4,342101,342555,342328,454
5528,3482918,4,10684062,10684222,10684142,160
5529,3482918,4,17376736,17376855,17376795,119
5530,3482918,5,6311196,6311397,6311296,201
5531,3482918,5,7930186,7930480,7930333,294
5532,3482918,5,8588462,8588698,8588580,236
5533,3482918,5,25682700,25682864,25682782,164
5534,3482919,1,24410112,24410268,24410190,156
5535,3482919,2,5216082,5216197,5216139,115
5536,3482919,3,11649031,11649160,11649095,129
5537,3482920,1,12497346,12497387,12497366,41
5538,3482920,1,24614393,24614456,24614424,63
5539,3482920,2,13940978,13941700,13941339,722
5540,3482920,2,18536106,18536921,18536513,815
5541,3482920,3,17400661,17400917,17400789,256
5542,3482920,3,22641982,22642111,22642046,129
5543,3482920,4,295512,297772,296642,2260
5544,3482920,4,11445340,11445863,11445601,523
5545,3482920,5,6490848,6491660,6491254,812
5546,3482920,5,14542608,14544028,14543318,1420
5547,3482920,5,24240313,24240908,24240610,595
5548,3482921,1,13038737,13038739,13038738,2
5549,3482921,1,16134187,16134201,16134194,14
5550,3482921,1,24620254,24621224,24620739,970
5551,3482921,2,12875474,12876159,12875816,685
5552,3482921,2,16296326,16298984,16297655,2658
5553,3482921,3,7594535,7594758,7594646,223
5554,3482921,3,9305775,9305911,9305843,136
5555,3482921,3,17271623,17272634,17272128,1011
5556,3482921,4,8978274,8978439,8978356,165
5557,3482921,5,2320543,2321054,2320798,511
5558,3482921,5,7334326,7334854,7334590,528
5559,3482921,5,19107972,19108944,19108458,972
5560,3482922,1,29383474,29383613,29383543,139
5561,3482922,2,7596691,7596843,7596767,152
5562,3482922,2,17445044,17445487,17445265,443
5563,3482922,3,16199583,16199646,16199614,63
5564,3482922,4,5725778,5725943,5725860,165
5565,3482922,5,20390313,20391386,20390849,1073
5566,3482923,1,17328165,17328182,17328173,17
5567,3482923,1,18585207,18585658,18585432,451
5568,3482923,1,29608176,29608212,29608194,36
5569,3482923,3,9153971,9154348,9154159,377
5570,3482923,4,8175580,8176235,8175907,655
5571,3482923,4,8704447,8705765,8705106,1318
5572,3482923,5,21153348,21153977,21153662,629
5573,3482923,5,25547123,25547385,25547254,262
5574,3482924,1,23776260,23776922,23776591,662
5575,3482924,2,6210789,6210849,6210819,60
5576,3482924,2,18845967,18846091,18846029,124
5577,3482924,3,885627,885648,885637,21
5578,3482924,4,1031019,1031358,1031188,339
5579,3482924,4,11345228,11345287,11345257,59
5580,3482924,4,11642402,11643041,11642721,639
5581,3482924,4,17537332,17537566,17537449,234
5582,3482924,5,7911888,7911910,7911899,22
5583,3482924,5,17534463,17535158,17534810,695
5584,3482924,5,26193878,26193901,26193889,23
5585,3482925,1,10551790,10552152,10551971,362
5586,3482925,1,25445643,25446231,25445937,588
5587,3482925,2,1006678,1006823,1006750,145
5588,3482925,2,2322133,2322138,2322135,5
5589,3482925,3,22744128,22744605,22744366,477
5590,3482925,5,4010424,4010648,4010536,224
5591,3482925,5,8629971,8630028,8629999,57
5592,3482925,5,18604968,18605531,18605249,563
5593,3482925,5,20085685,20085724,20085704,39
5594,3482926,1,11460487,11460584,11460535,97
5595,3482926,1,19881978,19882589,19882283,611
5596,3482926,1,24631883,24632225,24632054,342
5597,3482926,1,30280986,30281239,30281112,253
5598,3482926,2,14323071,14324385,14323728,1314
5599,3482926,3,16784653,16785165,16784909,512
5600,3482926,4,383873,384359,384116,486
5601,3482926,4,1240217,1240867,1240542,650
5602,3482926,4,11889437,11889625,11889531,188
5603,3482926,5,782582,783375,782978,793
5604,3482926,5,17631860,17631929,17631894,69
5605,3482926,5,24662241,24662445,24662343,204
5606,3482927,1,10078713,10079052,10078882,339
5607,3482927,1,17203127,17203140,17203133,13
5608,3482927,1,25191681,25193296,25192488,1615
5609,3482927,2,6292384,6293487,6292935,1103
5610,3482927,2,16592380,16592537,16592458,157
5611,3482927,3,4549112,4549176,4549144,64
5612,3482927,4,4823438,4824576,4824007,1138
5613,3482927,5,8569275,8569949,8569612,674
5614,3482928,1,30035131,30035381,30035256,250
5615,3482928,2,7810944,7811035,7810989,91
5616,3482928,3,1268115,1268962,1268538,847
5617,3482928,3,3647530,3647649,3647589,119
5618,3482928,3,14990485,14990579,14990532,94
5619,3482928,4,7066003,7066072,7066037,69
5620,3482928,4,10311837,10311954,10311895,117
5621,3482928,4,17301856,17302137,17301996,281
5622,3482928,5,7525853,7526848,7526350,995
5623,3482928,5,26231063,26231915,26231489,852
5624,3482929,1,8009431,8009618,8009524,187
5625,3482929,1,16473447,16474232,16473839,785
5626,3482929,1,20046434,20046785,20046609,351
5627,3482929,1,29488883,29489217,29489050,334
5628,3482929,1,30413724,30414080,30413902,356
5629,3482929,2,8071567,8071632,8071599,65
5630,3482929,3,11076816,11081405,11079110,4589
5631,3482929,3,17025456,17025956,17025706,500
5632,3482929,4,7229323,7229341,7229332,18
5633,3482929,5,7358093,7358231,7358162,138
5634,3482930,1,26685700,26686164,26685932,464
5635,3482930,2,6802479,6802673,6802576,194
5636,3482930,2,7299017,7299074,7299045,57
5637,3482930,2,16540992,16541638,16541315,646
5638,3482930,3,1810283,1810305,1810294,22
5639,3482930,3,15881322,15882007,15881664,685
5640,3482930,4,7737144,7737527,7737335,383
5641,3482930,4,15489574,15489628,15489601,54
5642,3482930,5,5769915,5770288,5770101,373
5643,3482934,1,24438913,24439216,24439064,303
5644,3482934,1,26162098,26162128,26162113,30
5645,3482934,2,5418733,5418809,5418771,76
5646,3482934,3,4768363,4770192,4769277,1829
5647,3482934,4,1253274,1253411,1253342,137
5648,3482935,1,2847808,2849453,2848630,1645
5649,3482935,1,19618908,19619045,19618976,137
5650,3482935,1,30212248,30212339,30212293,91
5651,3482935,2,8709792,8710824,8710308,1032
5652,3482935,3,8011402,8011716,8011559,314
5653,3482935,3,16188539,16188544,16188541,5
5654,3482935,4,17459338,17460203,17459770,865
5655,3482935,5,15976169,15977286,15976727,1117
5656,3482936,1,18330558,18330771,18330664,213
5657,3482936,1,20015500,20015889,20015694,389
5658,3482936,2,6022394,6022568,6022481,174
5659,3482936,2,18108087,18108396,18108241,309
5660,3482936,3,5201751,5203184,5202467,1433
5661,3482936,3,10034655,10035615,10035135,960
5662,3482936,3,12361684,12362429,12362056,745
5663,3482936,4,10295127,10295801,10295464,674
5664,3482937,1,19925852,19926884,19926368,1032
5665,3482937,2,12225387,12226297,12225842,910
5666,3482937,2,12997717,12998008,12997862,291
5667,3482937,3,15745040,15746278,15745659,1238
5668,3482937,4,8371758,8373207,8372482,1449
5669,3482937,5,8940391,8940892,8940641,501
5670,3482937,5,10189297,10189485,10189391,188
5671,3482937,5,19213403,19213495,19213449,92
5672,3482938,1,9018339,9018349,9018344,10
5673,3482938,2,8235310,8238181,8236745,2871
5674,3482938,3,17590441,17591206,17590823,765
5675,3482938,4,613562,615513,614537,1951
5676,3482938,4,12610117,12610362,12610239,245
5677,3482938,5,7645083,7645126,7645104,43
5678,3482938,5,8807028,8807100,8807064,72
5679,3482939,1,10970812,10971013,10970912,201
5680,3482939,1,25301746,25301844,25301795,98
5681,3482939,2,259107,259175,259141,68
5682,3482939,2,7315469,7316146,7315807,677
5683,3482939,2,18857542,18857662,18857602,120
5684,3482939,3,8587995,8588868,8588431,873
5685,3482939,3,16569271,16569407,16569339,136
5686,3482939,4,11967975,11968427,11968201,452
5687,3482939,5,21301806,21302035,21301920,229
5688,3482939,5,23778082,23779637,23778859,1555
5689,3482940,1,4546611,4546899,4546755,288
5690,3482940,1,27979579,27979725,27979652,146
5691,3482940,2,1256396,1256591,1256493,195
5692,3482940,2,12843501,12844208,12843854,707
5693,3482940,3,597991,598400,598195,409
5694,3482940,3,10749792,10750563,10750177,771
5695,3482940,3,14750825,14751010,14750917,185
5696,3482940,4,5462119,5462594,5462356,475
5697,3482940,5,1101693,1103106,1102399,1413
5698,3482940,5,8655707,8655709,8655708,2
5699,3482941,2,12298889,12300124,12299506,1235
5700,3482941,2,12583925,12584024,12583974,99
5701,3482941,3,1577834,1579293,1578563,1459
5702,3482941,3,5599720,5599802,5599761,82
5703,3482941,4,4802763,4806100,4804431,3337
5704,3482941,4,7626059,7626263,7626161,204
5705,3482941,5,26956029,26956265,26956147,236
5706,3482942,1,4790713,4791238,4790975,525
5707,3482942,1,26742353,26742548,26742450,195
5708,3482942,2,352047,352965,352506,918
5709,3482942,2,6807863,6807922,6807892,59
5710,3482942,2,9539526,9539640,9539583,114
5711,3482942,2,11646139,11646795,11646467,656
5712,3482942,3,7669898,7670175,7670036,277
5713,3482942,3,19148936,19150161,19149548,1225
5714,3482942,4,6955052,6956258,6955655,1206
5715,3482942,4,15626140,15626975,15626557,835
5716,3482943,1,279673,280584,280128,911
5717,3482943,1,9881487,9882382,9881934,895
5718,3482943,3,1466185,1466446,1466315,261
5719,3482943,4,6819258,6820566,6819912,1308
5720,3482943,5,18179973,18180110,18180041,137
5721,3482944,1,10214311,10216336,10215323,2025
5722,3482944,2,6539014,6539779,6539396,765
5723,3482944,2,18344270,18345421,18344845,1151
5724,3482944,3,3773924,3774330,3774127,406
5725,3482944,3,10795429,10797145,10796287,1716
5726,3482944,4,5365607,5365831,5365719,224
5727,3482944,4,5633069,5633510,5633289,441
5728,3482944,4,17543778,17544388,17544083,610
5729,3482944,5,21317764,21318748,21318256,984
5730,3482945,1,18698445,18698817,18698631,372
5731,3482945,1,26415995,26416518,26416256,523
5732,3482945,2,13940534,13940966,13940750,432
5733,3482945,4,11954093,11954504,11954298,411
5734,3482945,4,18395731,18396235,18395983,504
5735,3482945,5,599072,600064,599568,992
5736,3482945,5,18756645,18756699,18756672,54
5737,3482946,1,12433737,12434044,12433890,307
5738,3482946,1,21904664,21904824,21904744,160
5739,3482946,2,6017200,6018166,6017683,966
5740,3482946,2,11923450,11924504,11923977,1054
5741,3482946,3,16583221,16583229,16583225,8
5742,3482946,3,21314312,21315175,21314743,863
5743,3482946,4,671896,671933,671914,37
5744,3482946,4,858112,858298,858205,186
5745,3482946,5,10037789,10038332,10038060,543
5746,3482947,1,1566334,1566411,1566372,77
5747,3482947,1,1888493,1888559,1888526,66
5748,3482947,2,6036779,6036969,6036874,190
5749,3482947,2,10755041,10755077,10755059,36
5750,3482947,4,8396186,8396655,8396420,469
5751,3482947,4,10857073,10857234,10857153,161
5752,3482947,4,14806021,14806853,14806437,832
5753,3482947,5,16596755,16596905,16596830,150
5754,3482950,1,1903479,1904222,1903850,743
5755,3482950,1,10700100,10700323,10700211,223
5756,3482950,1,18199246,18199933,18199589,687
5757,3482950,2,5552527,5553923,5553225,1396
5758,3482950,3,2832132,2832200,2832166,68
5759,3482950,3,6739833,6740716,6740274,883
5760,3482950,4,9726291,9727734,9727012,1443
5761,3482950,4,16193230,16195683,16194456,2453
5762,3482950,5,13776360,13776368,13776364,8
5763,3482950,5,21145799,21146853,21146326,1054
5764,3482950,5,24605851,24606027,24605939,176
5765,3482951,1,20345148,20350818,20347983,5670
5766,3482951,1,24578014,24579047,24578530,1033
5767,3482951,2,1151052,1151135,1151093,83
5768,3482951,2,18369411,18369513,18369462,102
5769,3482951,5,6557325,6558185,6557755,860
5770,3482951,5,9073913,9076436,9075174,2523
5771,3482952,1,25531005,25531765,25531385,760
5772,3482952,2,9779088,9781121,9780104,2033
5773,3482952,2,15343233,15343331,15343282,98
5774,3482952,3,11307152,11307961,11307556,809
5775,3482952,3,11894451,11894603,11894527,152
5776,3482952,4,436030,436087,436058,57
5777,3482952,5,6587552,6587909,6587730,357
5778,3482952,5,26255639,26255805,26255722,166
5779,3482953,1,26735844,26737672,26736758,1828
5780,3482953,2,1710597,1710670,1710633,73
5781,3482953,2,7367463,7367528,7367495,65
5782,3482953,2,18731293,18731471,18731382,178
5783,3482953,3,3648550,3649380,3648965,830
5784,3482953,4,13098479,13099463,13098971,984
5785,3482953,5,278409,278491,278450,82
5786,3482953,5,8785790,8787491,8786640,1701
5787,3482953,5,15909632,15909679,15909655,47
5788,3482954,1,4228664,4230063,4229363,1399
5789,3482954,1,9456960,9457011,9456985,51
5790,3482954,1,22996715,22997190,22996952,475
5791,3482954,4,265711,265811,265761,100
5792,3482954,4,12343491,12343524,12343507,33
5793,3482954,5,1204563,1204759,1204661,196
5794,3482954,5,18604784,18604968,18604876,184
5795,3482954,5,26336155,26336923,26336539,768
5796,3482955,1,3772619,3772883,3772751,264
5797,3482955,1,24537259,24537444,24537351,185
5798,3482955,2,2272779,2273368,2273073,589
5799,3482955,2,6236991,6237001,6236996,10
5800,3482955,3,22679311,22679361,22679336,50
5801,3482955,4,11937057,11937175,11937116,118
5802,3482955,4,14982623,14982720,14982671,97
5803,3482955,5,1567794,1569022,1568408,1228
5804,3482955,5,21362114,21362818,21362466,704
5805,3482956,1,11292983,11293015,11292999,32
5806,3482956,2,386979,387072,387025,93
5807,3482956,2,6360559,6360637,6360598,78
5808,3482956,3,2613770,2613812,2613791,42
5809,3482956,5,1424959,1425726,1425342,767
5810,3482956,5,8804818,8804918,8804868,100
5811,3482956,5,17293981,17294041,17294011,60
5812,3482956,5,20913082,20913891,20913486,809
5813,3482957,1,8053694,8056730,8055212,3036
5814,3482957,1,18435141,18435292,18435216,151
5815,3482957,2,2096751,2096765,2096758,14
5816,3482957,3,8174679,8174775,8174727,96
5817,3482957,3,11110422,11112470,11111446,2048
5818,3482957,4,177937,178358,178147,421
5819,3482957,5,7776931,7778017,7777474,1086
5820,3482957,5,16756314,16758549,16757431,2235
5821,3482958,1,575623,576108,575865,485
5822,3482958,3,7595362,7595491,7595426,129
5823,3482958,3,7767670,7767756,7767713,86
5824,3482958,3,20530523,20530611,20530567,88
5825,3482958,4,6585991,6586437,6586214,446
5826,3482958,5,7334950,7335153,7335051,203
5827,3482959,1,11460090,11460130,11460110,40
5828,3482959,2,100543,100674,100608,131
5829,3482959,2,1062401,1062584,1062492,183
5830,3482959,2,6831786,6831885,6831835,99
5831,3482959,3,9664063,9665051,9664557,988
5832,3482959,3,16907163,16907541,16907352,378
5833,3482959,3,18269421,18271060,18270240,1639
5834,3482959,5,9887959,9888008,9887983,49
5835,3482960,1,4690072,4690603,4690337,531
5836,3482960,1,21644802,21646328,21645565,1526
5837,3482960,2,13386787,13387557,13387172,770
5838,3482960,4,11550901,11552896,11551898,1995
5839,3482960,5,17709973,17710029,17710001,56
5840,3482960,5,25921384,25922647,25922015,1263
5841,3482961,2,7332282,7332342,7332312,60
5842,3482961,3,9009482,9009613,9009547,131
5843,3482961,5,779662,780255,779958,593
5844,3482961,5,7980093,7980174,7980133,81
5845,3482961,5,17961505,17961924,17961714,419
5846,3482962,1,22821255,22822978,22822116,1723
5847,3482962,4,483710,483839,483774,129
5848,3482962,4,5388871,5388928,5388899,57
5849,3482962,5,6621419,6621866,6621642,447
5850,3482962,5,17972700,17972821,17972760,121
5851,3482963,1,2786642,2787118,2786880,476
5852,3482963,2,674936,676428,675682,1492
5853,3482963,3,9470074,9472642,9471358,2568
5854,3482963,3,19415351,19415988,19415669,637
5855,3482963,4,11923017,11924543,11923780,1526
5856,3482963,5,3244755,3247054,3245904,2299
5857,3482967,2,806790,806977,806883,187
5858,3482967,3,8223052,8223121,8223086,69
5859,3482967,4,577975,578631,578303,656
5860,3482967,5,948611,948924,948767,313
5861,3482967,5,8811035,8811109,8811072,74
5862,3482967,5,20677821,20677852,20677836,31
5863,3482967,5,21967990,21968111,21968050,121
5864,3482968,1,16067309,16067485,16067397,176
5865,3482968,1,19435151,19435279,19435215,128
5866,3482968,2,9669422,9669616,9669519,194
5867,3482968,2,10559838,10560972,10560405,1134
5868,3482968,3,3440180,3441652,3440916,1472
5869,3482968,3,4976850,4976914,4976882,64
5870,3482968,3,8143953,8144683,8144318,730
5871,3482968,4,755572,755640,755606,68
5872,3482968,4,1044010,1044028,1044019,18
5873,3482968,5,20050508,20051299,20050903,791
5874,3482968,5,24922993,24923905,24923449,912
5875,3482969,2,7902033,7902058,7902045,25
5876,3482969,2,10553104,10554790,10553947,1686
5877,3482969,3,8228407,8228425,8228416,18
5878,3482969,3,22859278,22859396,22859337,118
5879,3482969,4,9887909,9888774,9888341,865
5880,3482969,5,24820463,24820474,24820468,11
5881,3482970,1,10975554,10975665,10975609,111
5882,3482970,1,17304485,17305007,17304746,522
5883,3482970,1,26527183,26529190,26528186,2007
5884,3482970,3,18512806,18513032,18512919,226
5885,3482970,4,5301202,5301387,5301294,185
5886,3482970,4,10808133,10809101,10808617,968
5887,3482971,1,12239551,12239818,12239684,267
5888,3482971,2,11760079,11760286,11760182,207
5889,3482971,3,18797013,18797396,18797204,383
5890,3482971,4,16251032,16257404,16254218,6372
5891,3482971,5,24272721,24272845,24272783,124
5892,3482972,1,6871182,6871474,6871328,292
5893,3482972,2,17909071,17913783,17911427,4712
5894,3482972,3,4854672,4858053,4856362,3381
5895,3482972,3,16551680,16552190,16551935,510
5896,3482972,5,9803801,9805957,9804879,2156
5897,3482972,5,15249021,15249032,15249026,11
5898,3482973,1,25998899,25999603,25999251,704
5899,3482973,2,9675662,9676168,9675915,506
5900,3482973,2,12390322,12390511,12390416,189
5901,3482973,4,11012626,11013844,11013235,1218
5902,3482973,4,11706809,11707471,11707140,662
5903,3482973,5,8251068,8251074,8251071,6
5904,3482974,1,8435526,8435948,8435737,422
5905,3482974,1,17303262,17303947,17303604,685
5906,3482974,3,18022542,18022566,18022554,24
5907,3482974,4,9356907,9357066,9356986,159
5908,3482974,5,406190,407152,406671,962
5909,3482974,5,4428274,4428858,4428566,584
5910,3482974,5,19928309,19928632,19928470,323
5911,3482975,1,1214103,1215230,1214666,1127
5912,3482975,1,18348264,18348352,18348308,88
5913,3482975,2,763787,764853,764320,1066
5914,3482975,3,3505257,3506294,3505775,1037
5915,3482975,3,18252725,18253199,18252962,474
5916,3482975,4,393122,394640,393881,1518
5917,3482975,4,5371956,5371966,5371961,10
5918,3482975,4,10753232,10753481,10753356,249
5919,3482975,5,18979953,18982246,18981099,2293
5920,3482976,1,960887,963850,962368,2963
5921,3482976,1,21919180,21920773,21919976,1593
5922,3482976,2,11783130,11783483,11783306,353
5923,3482976,3,10513769,10513917,10513843,148
5924,3482976,4,8608233,8608354,8608293,121
5925,3482976,5,332140,332723,332431,583
5926,3482976,5,9828490,9828904,9828697,414
5927,3482976,5,16539398,16541036,16540217,1638
5928,3482976,5,18744369,18744529,18744449,160
5929,3482977,1,5808245,5808914,5808579,669
5930,3482977,1,15989607,15989667,15989637,60
5931,3482977,1,17831754,17832304,17832029,550
5932,3482977,2,16012939,16013053,16012996,114
5933,3482977,2,16250918,16251021,16250969,103
5934,3482977,3,3128225,3128391,3128308,166
5935,3482977,3,3205960,3205981,3205970,21
5936,3482977,4,1245087,1245235,1245161,148
5937,3482977,4,8503832,8504098,8503965,266
5938,3482977,4,9558093,9558116,9558104,23
5939,3482977,4,17368231,17371540,17369885,3309
5940,3482977,5,8848517,8848532,8848524,15
5941,3482978,1,6318268,6319504,6318886,1236
5942,3482978,1,16953965,16953972,16953968,7
5943,3482978,1,26865963,26866302,26866132,339
5944,3482978,2,849720,849988,849854,268
5945,3482978,2,8168512,8169703,8169107,1191
5946,3482978,2,16199114,16200176,16199645,1062
5947,3482978,5,1081685,1081790,1081737,105
5948,3482978,5,21640403,21640437,21640420,34
5949,3482978,5,23177940,23178084,23178012,144
5950,3482979,1,17171405,17171598,17171501,193
5951,3482979,2,6389323,6391188,6390255,1865
5952,3482979,3,6273524,6273673,6273598,149
5953,3482979,3,10737455,10738583,10738019,1128
5954,3482979,3,19630612,19631710,19631161,1098
5955,3482979,4,5423813,5424464,5424138,651
5956,3482979,5,16075954,16076339,16076146,385
5957,3482979,5,21455336,21455400,21455368,64
5958,3482980,1,642802,643447,643124,645
5959,3482980,1,28364685,28365229,28364957,544
5960,3482980,3,4749369,4750236,4749802,867
5961,3482980,3,11215996,11216546,11216271,550
5962,3482980,4,11735277,11735432,11735354,155
5963,3482980,5,763291,763485,763388,194
5964,3482980,5,19100220,19102187,19101203,1967
5965,3482981,1,437336,445271,441303,7935
5966,3482981,1,7001208,7001660,7001434,452
5967,3482981,1,11078099,11079746,11078922,1647
5968,3482981,2,11900415,11901951,11901183,1536
5969,3482981,3,1449145,1449238,1449191,93
5970,3482981,3,21763181,21767052,21765116,3871
5971,3482981,4,560747,560882,560814,135
5972,3482981,4,5370187,5370295,5370241,108
5973,3482981,4,10362639,10362681,10362660,42
5974,3482981,4,18507588,18507910,18507749,322
5975,3482981,5,8008734,8009873,8009303,1139
5976,3482981,5,14750547,14751116,14750831,569
5977,3482982,3,18817390,18820482,18818936,3092
5978,3482982,4,112205,112272,112238,67
5979,3482982,4,7434138,7434569,7434353,431
5980,3482982,5,777730,777940,777835,210
5981,3482982,5,16025563,16027391,16026477,1828
5982,3482982,5,22823366,22824617,22823991,1251
5983,3482983,1,784203,784382,784292,179
5984,3482983,1,13986427,13987609,13987018,1182
5985,3482983,1,30188244,30188514,30188379,270
5986,3482983,3,901089,901194,901141,105
5987,3482983,3,7949989,7950140,7950064,151
5988,3482983,3,19416875,19417000,19416937,125
5989,3482983,4,2827534,2827577,2827555,43
5990,3482983,4,6548119,6548310,6548214,191
5991,3482983,4,17867092,17868212,17867652,1120
5992,3482983,5,8044129,8044192,8044160,63
5993,3482983,5,22177356,22177853,22177604,497
5994,3482984,1,9937542,9937649,9937595,107
5995,3482984,1,12923200,12923577,12923388,377
5996,3482984,2,11588294,11588354,11588324,60
5997,3482984,3,325470,326136,325803,666
5998,3482984,3,17911127,17911713,17911420,586
5999,3482984,3,20066654,20066666,20066660,12
6000,3482984,4,11315182,11315526,11315354,344
6001,3482984,4,17598549,17599850,17599199,1301
6002,3482984,5,8261891,8262014,8261952,123
6003,3482984,5,14561521,14561628,14561574,107
6004,3482984,5,22828670,22828743,22828706,73
6005,3482985,1,13038933,13039224,13039078,291
6006,3482985,2,2929704,2930250,2929977,546
6007,3482985,2,18613881,18614092,18613986,211
6008,3482985,3,8879157,8879361,8879259,204
6009,3482985,3,18301651,18302582,18302116,931
6010,3482985,3,18846195,18846812,18846503,617
6011,3482985,3,22918165,22918218,22918191,53
6012,3482985,4,10151169,10152544,10151856,1375
6013,3482986,1,6575388,6575522,6575455,134
6014,3482986,1,7478782,7480006,7479394,1224
6015,3482986,1,30147143,30147688,30147415,545
6016,3482986,3,1251191,1251301,1251246,110
6017,3482986,3,17600840,17601478,17601159,638
6018,3482986,5,9966840,9967257,9967048,417
6019,3482986,5,22986918,22988619,22987768,1701
6020,3482987,3,20031193,20032134,20031663,941
6021,3482988,1,9197577,9198263,9197920,686
6022,3482988,1,17716180,17716304,17716242,124
6023,3482988,1,26240886,26240967,26240926,81
6024,3482988,2,6685008,6685024,6685016,16
6025,3482988,2,10160987,10161013,10161000,26
6026,3482988,2,17105660,17106541,17106100,881
6027,3482988,3,156203,156466,156334,263
6028,3482988,3,17691734,17692094,17691914,360
6029,3482988,3,22620933,22621331,22621132,398
6030,3482988,5,685088,685117,685102,29
6031,3482988,5,9196950,9198712,9197831,1762
6032,3482988,5,16134336,16135393,16134864,1057
6033,3482988,5,21600736,21600863,21600799,127
6034,3482989,1,22865962,22866199,22866080,237
6035,3482989,1,25888595,25888725,25888660,130
6036,3482989,2,255629,255649,255639,20
6037,3482989,3,21854638,21854649,21854643,11
6038,3482989,3,22376619,22377290,22376954,671
6039,3482989,4,5730805,5731037,5730921,232
6040,3482989,4,17392530,17392946,17392738,416
6041,3482989,5,10636740,10637289,10637014,549
6042,3482990,1,12974082,12974439,12974260,357
6043,3482990,1,16647146,16647325,16647235,179
6044,3482990,1,29366279,29366447,29366363,168
6045,3482990,2,865035,865755,865395,720
6046,3482990,2,18972842,18973376,18973109,534
6047,3482990,3,6299974,6301759,6300866,1785
6048,3482990,3,10840724,10840760,10840742,36
6049,3482990,3,18030871,18030925,18030898,54
6050,3482990,4,130310,131219,130764,909
6051,3482990,4,13591473,13591570,13591521,97
6052,3482990,5,3254154,3254259,3254206,105
6053,3482990,5,16658374,16658398,16658386,24
6054,3482991,1,11912460,11914409,11913434,1949
6055,3482991,1,18430897,18431691,18431294,794
6056,3482991,1,29870971,29871444,29871207,473
6057,3482991,2,1690241,1693043,1691642,2802
6058,3482991,2,17767203,17768165,17767684,962
6059,3482991,3,21240511,21240517,21240514,6
6060,3482991,4,6896486,6896576,6896531,90
6061,3482991,5,21578358,21578752,21578555,394
6062,3482992,1,609446,611128,610287,1682
6063,3482992,2,14275752,14276588,14276170,836
6064,3482992,2,14566549,14566805,14566677,256
6065,3482992,3,9930903,9931877,9931390,974
6066,3482992,3,10866018,10866034,10866026,16
6067,3482992,4,10857073,10857234,10857153,161
6068,3482992,5,13225975,13226056,13226015,81
6069,3482992,5,16332127,16332218,16332172,91
6070,3482992,5,24744202,24744495,24744348,293
6071,3482993,1,6673901,6674604,6674252,703
6072,3482993,2,190900,191007,190953,107
6073,3482993,2,13772475,13772494,13772484,19
6074,3482993,2,17250013,17251303,17250658,1290
6075,3482993,3,10739540,10741689,10740614,2149
6076,3482993,3,11281103,11281144,11281123,41
6077,3482993,3,19666652,19667602,19667127,950
6078,3482993,4,280328,280777,280552,449
6079,3482993,4,11300721,11301488,11301104,767
6080,3482993,5,10222144,10222166,10222155,22
6081,3482993,5,15866460,15866828,15866644,368
6082,3482993,5,22082709,22082906,22082807,197
6083,3482994,1,8946816,8947867,8947341,1051
6084,3482994,1,16604440,16604565,16604502,125
6085,3482994,1,23460129,23461440,23460784,1311
6086,3482994,2,6276427,6277053,6276740,626
6087,3482994,2,19315343,19316226,19315784,883
6088,3482994,3,6705633,6708464,6707048,2831
6089,3482994,3,16621385,16621622,16621503,237
6090,3482994,3,18246521,18246672,18246596,151
6091,3482994,4,6225487,6225539,6225513,52
6092,3482994,5,390794,393215,392004,2421
6093,3482994,5,18098476,18098889,18098682,413
6094,3482995,1,3398383,3398442,3398412,59
6095,3482995,1,26327939,26328821,26328380,882
6096,3482995,2,6505280,6505996,6505638,716
6097,3482995,2,9620991,9621024,9621007,33
6098,3482995,2,17415922,17416053,17415987,131
6099,3482995,3,17535934,17536040,17535987,106
6100,3482995,3,20045037,20045512,20045274,475
6101,3482995,4,15823473,15823798,15823635,325
6102,3482995,5,6338284,6339283,6338783,999
6103,3482995,5,21313437,21313951,21313694,514
6104,3482995,5,21330537,21331328,21330932,791
6105,3482996,1,2846860,2846900,2846880,40
6106,3482996,1,21331204,21331282,21331243,78
6107,3482996,2,1100861,1101431,1101146,570
6108,3482996,3,15759447,15760040,15759743,593
6109,3482996,3,19590292,19590440,19590366,148
6110,3482996,4,105424,106594,106009,1170
6111,3482996,4,9369991,9370879,9370435,888
6112,3482996,5,3304332,3305027,3304679,695
6113,3482996,5,14787845,14788233,14788039,388
6114,3482997,1,9231267,9231725,9231496,458
6115,3482997,1,20021220,20021264,20021242,44
6116,3482997,1,25399217,25400076,25399646,859
6117,3482997,2,1505281,1505299,1505290,18
6118,3482997,3,9675121,9675219,9675170,98
6119,3482997,3,10887779,10887817,10887798,38
6120,3482997,4,8448429,8450215,8449322,1786
6121,3482997,5,509009,509034,509021,25
6122,3482997,5,5834259,5835777,5835018,1518
6123,3482997,5,9013486,9014650,9014068,1164
6124,3482997,5,22737924,22738563,22738243,639
6125,3482997,5,24135377,24136070,24135723,693
6126,3482998,1,6871759,6871996,6871877,237
6127,3482998,1,24993000,24993323,24993161,323
6128,3482998,2,9081493,9084598,9083045,3105
6129,3482998,3,1108150,1108320,1108235,170
6130,3482998,5,4441475,4441798,4441636,323
6131,3482998,5,6220683,6221948,6221315,1265
6132,3482998,5,20383809,20385072,20384440,1263
6133,3482999,1,16548063,16548084,16548073,21
6134,3482999,1,29213762,29214953,29214357,1191
6135,3482999,2,6365800,6368009,6366904,2209
6136,3482999,2,18530982,18531564,18531273,582
6137,3482999,3,10952006,10952335,10952170,329
6138,3482999,4,141932,142055,141993,123
6139,3482999,4,6326179,6328464,6327321,2285
6140,3482999,4,10837369,10838832,10838100,1463
6141,3482999,5,17206718,17206724,17206721,6
6142,3483000,1,27646135,27646255,27646195,120
6143,3483000,2,238936,239053,238994,117
6144,3483000,5,8620248,8621990,8621119,1742
6145,3483000,5,10630093,10630217,10630155,124
6146,3483000,5,19019739,19020035,19019887,296
6147,3483001,1,2653132,2653320,2653226,188
6148,3483001,2,6016827,6016840,6016833,13
6149,3483001,3,1674774,1675142,1674958,368
6150,3483001,3,17942497,17943535,17943016,1038
6151,3483001,4,10851187,10851822,10851504,635
6152,3483001,5,767404,767637,767520,233
6153,3483002,1,9124574,9124621,9124597,47
6154,3483002,1,23020776,23021229,23021002,453
6155,3483002,1,24528864,24528982,24528923,118
6156,3483002,4,9897423,9897743,9897583,320
6157,3483002,5,6510352,6511380,6510866,1028
6158,3483003,1,3266590,3266763,3266676,173
6159,3483003,2,10911002,10911045,10911023,43
6160,3483003,3,15741055,15741173,15741114,118
6161,3483003,3,21044970,21045206,21045088,236
6162,3483003,4,1434697,1436313,1435505,1616
6163,3483003,4,9666730,9666736,9666733,6
6164,3483003,5,7902180,7902313,7902246,133
6165,3483003,5,21144297,21144445,21144371,148
6166,3483003,5,22860221,22860265,22860243,44
6167,3483004,1,9806073,9807335,9806704,1262
6168,3483004,1,16916110,16916659,16916384,549
6169,3483004,2,2089521,2089716,2089618,195
6170,3483004,3,15674262,15674335,15674298,73
6171,3483004,4,5786332,5786532,5786432,200
6172,3483005,1,18024608,18026856,18025732,2248
6173,3483005,2,232631,233250,232940,619
6174,3483005,2,7045036,7046890,7045963,1854
6175,3483005,2,16482375,16483018,16482696,643
6176,3483005,3,10375990,10376152,10376071,162
6177,3483005,4,742533,742861,742697,328
6178,3483005,4,6538893,6539143,6539018,250
6179,3483005,4,13697116,13697505,13697310,389
6180,3483005,5,461321,461384,461352,63
6181,3483005,5,15364544,15366735,15365639,2191
6182,3483005,5,17695570,17695683,17695626,113
6183,3483006,2,742961,743661,743311,700
6184,3483006,2,6669805,6670379,6670092,574
6185,3483006,2,12203732,12204252,12203992,520
6186,3483006,3,9052408,9052541,9052474,133
6187,3483006,3,9779857,9779901,9779879,44
6188,3483006,3,21327214,21327637,21327425,423
6189,3483006,3,21882233,21882279,21882256,46
6190,3483006,4,11632891,11633418,11633154,527
6191,3483006,5,873180,873225,873202,45
6192,3483006,5,9225785,9225859,9225822,74
6193,3483006,5,9635983,9635998,9635990,15
6194,3483007,1,22007143,22007379,22007261,236
6195,3483007,1,28905276,28905429,28905352,153
6196,3483007,2,1553559,1553651,1553605,92
6197,3483007,2,9140590,9140877,9140733,287
6198,3483007,2,19261210,19263042,19262126,1832
6199,3483007,3,2586987,2587524,2587255,537
6200,3483007,4,402578,402766,402672,188
6201,3483007,4,5564665,5564818,5564741,153
6202,3483007,5,1923151,1923237,1923194,86
6203,3483008,1,12967474,12967550,12967512,76
6204,3483008,1,20594195,20594568,20594381,373
6205,3483008,1,28926193,28926323,28926258,130
6206,3483008,2,7590320,7590890,7590605,570
6207,3483008,2,17972426,17973044,17972735,618
6208,3483008,3,631050,631531,631290,481
6209,3483008,3,10651235,10651498,10651366,263
6210,3483008,3,21746413,21746506,21746459,93
6211,3483008,4,6328464,6329850,6329157,1386
6212,3483008,5,15379638,15379723,15379680,85
6213,3483009,2,8781842,8782372,8782107,530
6214,3483009,3,1349955,1350656,1350305,701
6215,3483009,3,15641577,15642062,15641819,485
6216,3483009,3,17139514,17139598,17139556,84
6217,3483009,3,20002977,20003990,20003483,1013
6218,3483009,5,9504460,9505695,9505077,1235
6219,3483010,1,16503531,16503586,16503558,55
6220,3483010,1,26886937,26888662,26887799,1725
6221,3483010,1,29044150,29044297,29044223,147
6222,3483010,2,15988103,15988602,15988352,499
6223,3483010,3,2636194,2636466,2636330,272
6224,3483010,3,17092088,17093256,17092672,1168
6225,3483010,4,7117914,7119746,7118830,1832
6226,3483010,5,1542180,1550443,1546311,8263
6227,3483010,5,4507967,4508663,4508315,696
6228,3483011,1,16918571,16918792,16918681,221
6229,3483011,4,9348191,9349050,9348620,859
6230,3483011,5,4892809,4892826,4892817,17
6231,3483011,5,20946673,20949354,20948013,2681
6232,3483012,1,11451357,11451450,11451403,93
6233,3483012,2,9617456,9617809,9617632,353
6234,3483012,3,22351051,22351123,22351087,72
6235,3483012,5,13337188,13338959,13338073,1771
6236,3483013,1,6675302,6675366,6675334,64
6237,3483013,2,423142,424704,423923,1562
6238,3483013,2,2918423,2920270,2919346,1847
6239,3483013,3,2772304,2772605,2772454,301
6240,3483013,3,6547659,6547810,6547734,151
6241,3483013,3,8895149,8896019,8895584,870
6242,3483013,5,1793906,1794213,1794059,307
6243,3483013,5,6451539,6452611,6452075,1072
6244,3483013,5,26170989,26171691,26171340,702
6245,3483014,1,1690910,1691529,1691219,619
6246,3483014,1,6383209,6384657,6383933,1448
6247,3483014,1,17549949,17550135,17550042,186
6248,3483014,1,24697181,24697373,24697277,192
6249,3483014,2,11273175,11273219,11273197,44
6250,3483014,2,16145325,16146192,16145758,867
6251,3483014,3,17510890,17511511,17511200,621
6252,3483014,4,1526021,1526429,1526225,408
6253,3483014,5,21914274,21914322,21914298,48
6254,3483014,5,23208730,23214138,23211434,5408
6255,3483015,1,518107,518373,518240,266
6256,3483015,1,30404314,30405271,30404792,957
6257,3483015,2,2100291,2100326,2100308,35
6258,3483015,2,11970313,11971374,11970843,1061
6259,3483015,3,11215721,11216546,11216133,825
6260,3483015,4,6174478,6174497,6174487,19
6261,3483015,4,6324569,6325256,6324912,687
6262,3483015,4,17322769,17323569,17323169,800
6263,3483015,5,8337189,8337890,8337539,701
6264,3483015,5,16055096,16055209,16055152,113
6265,3483016,3,6488115,6488229,6488172,114
6266,3483016,3,8288301,8288362,8288331,61
6267,3483016,3,17539366,17539542,17539454,176
6268,3483017,1,16785379,16785446,16785412,67
6269,3483017,2,277540,277548,277544,8
6270,3483017,2,6474052,6474404,6474228,352
6271,3483017,2,10068934,10069127,10069030,193
6272,3483017,3,2885755,2885933,2885844,178
6273,3483017,3,23353612,23354128,23353870,516
6274,3483017,4,7246616,7247349,7246982,733
6275,3483017,5,10263458,10263540,10263499,82
6276,3483017,5,25942516,25942775,25942645,259
6277,3483018,1,4894949,4895565,4895257,616
6278,3483018,1,6511016,6511476,6511246,460
6279,3483018,1,28952599,28952755,28952677,156
6280,3483018,2,83764,83795,83779,31
6281,3483018,2,6777391,6777531,6777461,140
6282,3483018,3,10693069,10693129,10693099,60
6283,3483018,4,12371495,12371640,12371567,145
6284,3483018,5,4812031,4813099,4812565,1068
6285,3483018,5,9356501,9357047,9356774,546
6286,3483019,1,11461142,11461169,11461155,27
6287,3483019,1,21534470,21534933,21534701,463
6288,3483019,2,2281162,2282406,2281784,1244
6289,3483019,3,7732287,7732338,7732312,51
6290,3483019,4,665239,665544,665391,305
6291,3483019,4,7395989,7396347,7396168,358
6292,3483019,4,13133417,13133725,13133571,308
6293,3483019,5,21839001,21839528,21839264,527
6294,3483020,1,6987772,6987869,6987820,97
6295,3483020,1,27191975,27192143,27192059,168
6296,3483020,3,8722219,8722381,8722300,162
6297,3483020,5,19534436,19535822,19535129,1386
6298,3483021,1,28402414,28402955,28402684,541
6299,3483021,2,10240949,10241063,10241006,114
6300,3483021,2,18594273,18594355,18594314,82
6301,3483021,3,6168799,6169317,6169058,518
6302,3483021,3,9371903,9372007,9371955,104
6303,3483021,3,18608372,18608416,18608394,44
6304,3483021,4,12163321,12163575,12163448,254
6305,3483021,5,1148573,1148818,1148695,245
6306,3483021,5,1980214,1980235,1980224,21
6307,3483021,5,15374531,15374556,15374543,25
6308,3483021,5,23085848,23086039,23085943,191
6309,3483021,5,26115919,26116223,26116071,304
6310,3483022,1,1487994,1488642,1488318,648
6311,3483022,1,12245550,12245879,12245714,329
6312,3483022,1,13457948,13459532,13458740,1584
6313,3483022,1,17539792,17539843,17539817,51
6314,3483022,1,21098933,21100049,21099491,1116
6315,3483022,2,9465683,9466712,9466197,1029
6316,3483022,2,19339146,19339424,19339285,278
6317,3483022,3,17185497,17185626,17185561,129
6318,3483022,4,658198,665239,661718,7041
6319,3483022,5,17654434,17654716,17654575,282
6320,3483023,1,23166352,23169907,23168129,3555
6321,3483023,1,24032382,24033731,24033056,1349
6322,3483023,3,18806062,18806358,18806210,296
6323,3483023,4,7440684,7440769,7440726,85
6324,3483023,4,8112277,8112418,8112347,141
6325,3483023,4,17037940,17038397,17038168,457
6326,3483024,1,7371512,7372064,7371788,552
6327,3483024,1,18534251,18534941,18534596,690
6328,3483025,1,10328338,10328511,10328424,173
6329,3483025,1,21437629,21439314,21438471,1685
6330,3483025,3,7902044,7902790,7902417,746
6331,3483025,3,22922948,22923009,22922978,61
6332,3483025,5,517201,517725,517463,524
6333,3483025,5,16618121,16618560,16618340,439
6334,3483025,5,21652061,21652228,21652144,167
6335,3483026,1,5601540,5601629,5601584,89
6336,3483026,1,9975089,9976025,9975557,936
6337,3483026,1,25752524,25752904,25752714,380
6338,3483026,2,17827314,17827437,17827375,123
6339,3483026,3,10679605,10679950,10679777,345
6340,3483026,3,18633971,18635598,18634784,1627
6341,3483026,5,9913838,9913931,9913884,93
6342,3483027,1,25555635,25555804,25555719,169
6343,3483027,2,188633,189081,188857,448
6344,3483027,2,9613994,9614081,9614037,87
6345,3483027,3,6718426,6719554,6718990,1128
6346,3483027,3,22657760,22657776,22657768,16
6347,3483027,4,189438,189527,189482,89
6348,3483027,4,16895715,16896616,16896165,901
6349,3483027,5,7555276,7559658,7557467,4382
6350,3483027,5,13660855,13660882,13660868,27
6351,3483027,5,25399143,25400016,25399579,873
6352,3483028,1,9927561,9927686,9927623,125
6353,3483028,1,26541693,26542807,26542250,1114
6354,3483028,2,9201531,9201929,9201730,398
6355,3483028,2,17006415,17006622,17006518,207
6356,3483028,3,4951465,4951532,4951498,67
6357,3483028,4,905002,905133,905067,131
6358,3483028,5,1464592,1466711,1465651,2119
6359,3483029,1,4155277,4155803,4155540,526
6360,3483029,1,19514679,19516033,19515356,1354
6361,3483029,1,26405126,26405581,26405353,455
6362,3483029,2,9520875,9522856,9521865,1981
6363,3483029,2,16826466,16826728,16826597,262
6364,3483029,3,9042189,9042792,9042490,603
6365,3483029,3,9670039,9670069,9670054,30
6366,3483029,3,22129272,22129894,22129583,622
6367,3483029,4,9740504,9740617,9740560,113
6368,3483029,5,5803051,5804072,5803561,1021
6369,3483029,5,14239651,14240145,14239898,494
6370,3483029,5,23685707,23686165,23685936,458
6371,3483030,1,11350526,11350775,11350650,249
6372,3483030,1,13051082,13052023,13051552,941
6373,3483030,1,27077697,27077907,27077802,210
6374,3483030,2,6214560,6215132,6214846,572
6375,3483030,2,12377672,12379655,12378663,1983
6376,3483030,4,8642145,8643155,8642650,1010
6377,3483030,5,17909808,17911469,17910638,1661
6378,3483030,5,22310313,22310411,22310362,98
6379,3483031,1,13033012,13033405,13033208,393
6380,3483031,4,4827197,4827474,4827335,277
6381,3483031,4,6934256,6935403,6934829,1147
6382,3483031,4,18261394,18261458,18261426,64
6383,3483031,5,6689838,6690827,6690332,989
6384,3483031,5,7846051,7846970,7846510,919
6385,3483031,5,26516441,26516568,26516504,127
6386,3483032,1,11463694,11464000,11463847,306
6387,3483032,1,29073365,29074963,29074164,1598
6388,3483032,2,9966033,9967189,9966611,1156
6389,3483032,3,8722219,8722381,8722300,162
6390,3483032,5,493987,494110,494048,123
6391,3483032,5,5180846,5181954,5181400,1108
6392,3483032,5,21369490,21369844,21369667,354
6393,3483032,5,25080278,25080608,25080443,330
6394,3483033,2,1007543,1007797,1007670,254
6395,3483033,2,18991532,18992150,18991841,618
6396,3483033,3,20902367,20902555,20902461,188
6397,3483033,4,6293207,6293513,6293360,306
6398,3483033,5,782426,782566,782496,140
6399,3483033,5,8106909,8108936,8107922,2027
6400,3483033,5,23784452,23784824,23784638,372
6401,3483034,2,429170,429190,429180,20
6402,3483034,2,9749276,9750437,9749856,1161
6403,3483034,2,12269665,12272151,12270908,2486
6404,3483034,4,6167067,6167473,6167270,406
6405,3483034,4,6200403,6200437,6200420,34
6406,3483034,4,16549691,16550031,16549861,340
6407,3483034,5,9828904,9829256,9829080,352
6408,3483035,1,6093096,6093524,6093310,428
6409,3483035,2,13912977,13913989,13913483,1012
6410,3483035,4,10178825,10178861,10178843,36
6411,3483035,5,2182743,2183359,2183051,616
6412,3483036,1,916180,916556,916368,376
6413,3483036,1,16901723,16907562,16904642,5839
6414,3483036,1,19819633,19820635,19820134,1002
6415,3483036,2,10939635,10940721,10940178,1086
6416,3483036,2,12617670,12618982,12618326,1312
6417,3483036,3,9413692,9415139,9414415,1447
6418,3483036,4,8460941,8461568,8461254,627
6419,3483036,5,14924004,14924093,14924048,89
6420,3483036,5,25102251,25102445,25102348,194
6421,3483037,1,19618620,19619045,19618832,425
6422,3483037,2,8063265,8064047,8063656,782
6423,3483037,2,11680525,11680845,11680685,320
6424,3483037,3,9838946,9846009,9842477,7063
6425,3483037,3,20640685,20641578,20641131,893
6426,3483037,4,17329191,17330152,17329671,961
6427,3483037,4,18461237,18461768,18461502,531
6428,3483037,5,17995605,17997827,17996716,2222
6429,3483038,1,5255772,5255920,5255846,148
6430,3483038,1,6105922,6106053,6105987,131
6431,3483038,1,6791439,6791491,6791465,52
6432,3483038,1,19502031,19502363,19502197,332
6433,3483038,1,24010134,24010282,24010208,148
6434,3483038,2,9920530,9921743,9921136,1213
6435,3483038,2,18260466,18260762,18260614,296
6436,3483038,4,5430330,5430462,5430396,132
6437,3483038,5,576637,577714,577175,1077
6438,3483038,5,10237894,10239657,10238775,1763
6439,3483038,5,21765750,21779647,21772698,13897
6440,3483039,1,8142655,8143565,8143110,910
6441,3483039,1,17253368,17253798,17253583,430
6442,3483039,1,28350786,28351017,28350901,231
6443,3483039,2,7037285,7037586,7037435,301
6444,3483039,2,15050483,15050623,15050553,140
6445,3483039,4,803630,803769,803699,139
6446,3483039,4,5230175,5230311,5230243,136
6447,3483039,5,130869,131227,131048,358
6448,3483040,1,16765926,16766048,16765987,122
6449,3483040,1,20022128,20022541,20022334,413
6450,3483040,3,5263304,5263431,5263367,127
6451,3483040,3,5963183,5963497,5963340,314
6452,3483041,1,1996005,1996613,1996309,608
6453,3483041,1,4359665,4359944,4359804,279
6454,3483041,1,24488801,24488869,24488835,68
6455,3483041,2,905369,905435,905402,66
6456,3483041,3,7212058,7213373,7212715,1315
6457,3483041,5,5811515,5811560,5811537,45
6458,3483042,1,6155075,6155717,6155396,642
6459,3483042,1,7438312,7438607,7438459,295
6460,3483042,2,9026970,9028025,9027497,1055
6461,3483042,2,9950741,9950910,9950825,169
6462,3483042,2,13039828,13040058,13039943,230
6463,3483042,2,14371426,14374019,14372722,2593
6464,3483042,2,18511978,18512470,18512224,492
6465,3483042,3,3460895,3460925,3460910,30
6466,3483042,3,9070430,9071062,9070746,632
6467,3483042,3,9873333,9873399,9873366,66
6468,3483042,4,718290,720213,719251,1923
6469,3483042,4,7515529,7516557,7516043,1028
6470,3483042,4,13111151,13111458,13111304,307
6471,3483042,4,17711098,17711517,17711307,419
6472,3483042,5,5398815,5399999,5399407,1184
6473,3483042,5,7095841,7096020,7095930,179
6474,3483043,1,12940943,12941365,12941154,422
6475,3483043,1,17530358,17530389,17530373,31
6476,3483043,1,29485540,29486081,29485810,541
6477,3483043,2,4824593,4824777,4824685,184
6478,3483043,3,22658456,22658526,22658491,70
6479,3483043,5,8728116,8730309,8729212,2193
6480,3483043,5,17180836,17180946,17180891,110
6481,3483044,1,1725732,1725983,1725857,251
6482,3483044,1,28967290,28968213,28967751,923
6483,3483044,2,6316771,6316818,6316794,47
6484,3483044,2,18904238,18905078,18904658,840
6485,3483044,4,5849120,5849288,5849204,168
6486,3483044,5,9303075,9304881,9303978,1806
6487,3483045,1,3544107,3544182,3544144,75
6488,3483045,1,27552933,27552985,27552959,52
6489,3483045,2,6321483,6321843,6321663,360
6490,3483045,2,18054011,18054242,18054126,231
6491,3483045,3,1469415,1471616,1470515,2201
6492,3483045,4,11914834,11916104,11915469,1270
6493,3483045,5,1266411,1267480,1266945,1069
6494,3483045,5,8373547,8374606,8374076,1059
6495,3483045,5,25544272,25544732,25544502,460
6496,3483046,1,25907823,25909069,25908446,1246
6497,3483046,1,27905451,27905533,27905492,82
6498,3483046,2,12399503,12399781,12399642,278
6499,3483046,2,12823940,12824464,12824202,524
6500,3483046,3,8778369,8778814,8778591,445
6501,3483046,4,5005757,5005897,5005827,140
6502,3483046,5,15254227,15254311,15254269,84
6503,3483047,1,18503678,18505264,18504471,1586
6504,3483047,1,22323452,22323539,22323495,87
6505,3483047,1,27966997,27967106,27967051,109
6506,3483047,2,2256804,2258623,2257713,1819
6507,3483047,2,8487996,8490785,8489390,2789
6508,3483047,4,6121253,6122164,6121708,911
6509,3483047,4,10375164,10379494,10377329,4330
6510,3483048,2,7944442,7944537,7944489,95
6511,3483048,3,18203656,18204039,18203847,383
6512,3483048,4,189438,189527,189482,89
6513,3483048,4,13540485,13540670,13540577,185
6514,3483048,4,17527160,17527412,17527286,252
6515,3483048,5,9818496,9819761,9819128,1265
6516,3483049,1,22814036,22814131,22814083,95
6517,3483049,2,805546,806674,806110,1128
6518,3483049,3,11801301,11801838,11801569,537
6519,3483049,4,5384806,5385054,5384930,248
6520,3483049,5,22997204,22997470,22997337,266
6521,3483049,5,26377604,26378935,26378269,1331
6522,3483050,1,11446151,11446481,11446316,330
6523,3483050,1,21151127,21151315,21151221,188
6524,3483050,2,10792600,10792856,10792728,256
6525,3483050,2,12006181,12010188,12008184,4007
6526,3483050,3,7133522,7134269,7133895,747
6527,3483050,3,10431673,10431682,10431677,9
6528,3483050,4,6929713,6931668,6930690,1955
6529,3483050,5,443859,444169,444014,310
6530,3483051,1,9960525,9960608,9960566,83
6531,3483051,2,386140,386886,386513,746
6532,3483051,2,10214028,10214093,10214060,65
6533,3483051,3,8005109,8006180,8005644,1071
6534,3483051,3,18518772,18518874,18518823,102
6535,3483051,5,26023230,26023410,26023320,180
6536,3483052,1,533748,535046,534397,1298
6537,3483052,1,13033012,13033405,13033208,393
6538,3483052,1,16479728,16480850,16480289,1122
6539,3483052,2,12362996,12364001,12363498,1005
6540,3483052,2,18440489,18440975,18440732,486
6541,3483052,3,4841306,4842238,4841772,932
6542,3483052,3,10614999,10616417,10615708,1418
6543,3483052,4,5755885,5755988,5755936,103
6544,3483052,5,6386588,6386940,6386764,352
6545,3483053,1,24661784,24661892,24661838,108
6546,3483053,1,28145030,28145232,28145131,202
6547,3483053,2,608013,608353,608183,340
6548,3483053,3,15916130,15916257,15916193,127
6549,3483053,3,16164102,16164359,16164230,257
6550,3483053,5,13879344,13879478,13879411,134
6551,3483054,1,12658400,12658787,12658593,387
6552,3483054,2,256238,256331,256284,93
6553,3483054,3,11104189,11104291,11104240,102
6554,3483054,5,18589099,18589283,18589191,184
6555,3483055,1,11667083,11667109,11667096,26
6556,3483055,1,26439361,26439455,26439408,94
6557,3483055,1,29358954,29359039,29358996,85
6558,3483055,3,16895061,16895880,16895470,819
6559,3483055,4,7430445,7430450,7430447,5
6560,3483055,5,2233931,2234031,2233981,100
6561,3483055,5,20690905,20691049,20690977,144
6562,3483056,1,11201447,11202892,11202169,1445
6563,3483056,1,30075475,30075737,30075606,262
6564,3483056,2,12757165,12757304,12757234,139
6565,3483056,3,832417,832865,832641,448
6566,3483056,4,8000343,8001757,8001050,1414
6567,3483056,4,17847460,17849597,17848528,2137
6568,3483056,5,4714984,4718021,4716502,3037
6569,3483056,5,8644295,8644650,8644472,355
6570,3483056,5,26602710,26602877,26602793,167
6571,3483057,3,19103908,19105656,19104782,1748
6572,3483057,5,1718145,1718394,1718269,249
6573,3483058,1,26398996,26399036,26399016,40
6574,3483058,2,6904759,6906066,6905412,1307
6575,3483058,2,11977357,11977492,11977424,135
6576,3483058,2,15381014,15381778,15381396,764
6577,3483058,2,18494119,18494403,18494261,284
6578,3483058,3,11696713,11697164,11696938,451
6579,3483058,3,16648622,16648643,16648632,21
6580,3483058,4,3145403,3145478,3145440,75
6581,3483059,1,12003586,12003588,12003587,2
6582,3483059,1,21228681,21229027,21228854,346
6583,3483059,2,2097234,2097241,2097237,7
6584,3483059,2,6368589,6368774,6368681,185
6585,3483059,3,4109929,4109957,4109943,28
6586,3483059,4,478305,479017,478661,712
6587,3483059,4,13722184,13723073,13722628,889
6588,3483059,5,1922966,1923026,1922996,60
6589,3483059,5,14752719,14752893,14752806,174
6590,3483060,1,19365747,19365775,19365761,28
6591,3483060,1,20188817,20190880,20189848,2063
6592,3483060,1,26786510,26786665,26786587,155
6593,3483060,2,551591,554413,553002,2822
6594,3483060,3,196872,198224,197548,1352
6595,3483060,4,596384,596680,596532,296
6596,3483060,5,25301561,25301978,25301769,417
6597,3483061,2,8525670,8526743,8526206,1073
6598,3483061,3,2545867,2549868,2547867,4001
6599,3483061,3,17497916,17498305,17498110,389
6600,3483061,4,16530470,16531050,16530760,580
6601,3483061,5,8654894,8655320,8655107,426
6602,3483061,5,14912193,14912488,14912340,295
6603,3483062,1,11010776,11011243,11011009,467
6604,3483062,1,24988032,24988250,24988141,218
6605,3483062,2,8549594,8551940,8550767,2346
6606,3483062,3,667579,667634,667606,55
6607,3483062,4,8445831,8446278,8446054,447
6608,3483062,4,16972392,16973746,16973069,1354
6609,3483062,5,9080363,9081030,9080696,667
6610,3483063,1,7112430,7112534,7112482,104
6611,3483063,1,18166460,18166987,18166723,527
6612,3483063,1,28969083,28969223,28969153,140
6613,3483063,2,1490496,1490865,1490680,369
6614,3483063,3,1855157,1855491,1855324,334
6615,3483063,4,176314,177047,176680,733
6616,3483063,5,8145776,8146842,8146309,1066
6617,3483063,5,16427817,16428017,16427917,200
6618,3483064,1,9627970,9628934,9628452,964
6619,3483064,1,17240210,17240341,17240275,131
6620,3483064,1,29503142,29503257,29503199,115
6621,3483064,2,428117,428212,428164,95
6622,3483064,4,6103833,6107366,6105599,3533
6623,3483064,4,10474333,10474405,10474369,72
6624,3483064,5,941832,942737,942284,905
6625,3483065,1,2231989,2233557,2232773,1568
6626,3483065,1,11602982,11603503,11603242,521
6627,3483065,2,16978113,16978934,16978523,821
6628,3483065,3,10656277,10656307,10656292,30
6629,3483065,3,22962746,22963070,22962908,324
6630,3483065,4,10224153,10224450,10224301,297
6631,3483065,5,14277677,14278032,14277854,355
6632,3483066,1,13900236,13900717,13900476,481
6633,3483066,1,28929380,28929651,28929515,271
6634,3483066,2,18536106,18536921,18536513,815
6635,3483066,3,16290668,16290711,16290689,43
6636,3483066,3,18674157,18676757,18675457,2600
6637,3483066,4,8413721,8413968,8413844,247
6638,3483066,4,14430680,14430756,14430718,76
6639,3483066,5,636367,636499,636433,132
6640,3483066,5,21173159,21174283,21173721,1124
6641,3483067,1,18273033,18273131,18273082,98
6642,3483067,2,18025444,18025694,18025569,250
6643,3483067,3,8533768,8535351,8534559,1583
6644,3483067,3,17086257,17087564,17086910,1307
6645,3483067,5,8670520,8670585,8670552,65
6646,3483068,1,8292266,8292796,8292531,530
6647,3483068,1,24916391,24917376,24916883,985
6648,3483068,1,26786665,26788364,26787514,1699
6649,3483068,2,588358,588366,588362,8
6650,3483068,2,18298150,18298811,18298480,661
6651,3483068,3,5737570,5738376,5737973,806
6652,3483068,3,6268794,6269074,6268934,280
6653,3483068,3,19206626,19206763,19206694,137
6654,3483068,3,22459936,22461738,22460837,1802
6655,3483068,4,11826643,11826682,11826662,39
6656,3483068,5,14090753,14090817,14090785,64
6657,3483068,5,22178654,22178685,22178669,31
6658,3483069,1,29702459,29703184,29702821,725
6659,3483069,2,200516,200587,200551,71
6660,3483069,2,15956309,15957226,15956767,917
6661,3483069,3,21626834,21629053,21627943,2219
6662,3483069,4,5089680,5089830,5089755,150
6663,3483069,4,18309915,18310259,18310087,344
6664,3483069,5,1924513,1927708,1926110,3195
6665,3483069,5,16537651,16539398,16538524,1747
6666,3483069,5,22768398,22769450,22768924,1052
6667,3483070,1,11827897,11827904,11827900,7
6668,3483070,2,12247121,12247239,12247180,118
6669,3483070,2,19403673,19405540,19404606,1867
6670,3483070,3,17474568,17474703,17474635,135
6671,3483070,4,5187772,5188625,5188198,853
6672,3483070,5,10430552,10430808,10430680,256
6673,3483070,5,20096536,20097073,20096804,537
6674,3483071,1,1371967,1372058,1372012,91
6675,3483071,1,18544604,18545258,18544931,654
6676,3483071,1,23899174,23899832,23899503,658
6677,3483071,2,10310046,10310097,10310071,51
6678,3483071,3,2832274,2832447,2832360,173
6679,3483071,3,3707929,3708840,3708384,911
6680,3483071,3,19610802,19610979,19610890,177
6681,3483071,3,21237703,21241444,21239573,3741
6682,3483071,4,8699953,8700750,8700351,797
6683,3483071,4,10807164,10807516,10807340,352
6684,3483071,5,4575696,4576333,4576014,637
6685,3483072,3,10745057,10745852,10745454,795
6686,3483072,3,14790361,14790884,14790622,523
6687,3483072,3,20348159,20349792,20348975,1633
6688,3483072,5,22684613,22687294,22685953,2681
6689,3483073,5,8620789,8621990,8621389,1201
6690,3483074,1,17682786,17683407,17683096,621
6691,3483074,3,10945843,10946762,10946302,919
6692,3483074,4,8416781,8418315,8417548,1534
6693,3483074,4,15481747,15481826,15481786,79
6694,3483074,5,14594296,14594792,14594544,496
6695,3483075,1,5398374,5398779,5398576,405
6696,3483075,1,16928034,16933271,16930652,5237
6697,3483075,1,28387938,28388068,28388003,130
6698,3483075,2,862617,863057,862837,440
6699,3483075,3,4436691,4439453,4438072,2762
6700,3483075,3,11003425,11003898,11003661,473
6701,3483075,3,20528603,20529004,20528803,401
6702,3483075,4,7573424,7574943,7574183,1519
6703,3483075,5,10481256,10482161,10481708,905
6704,3483075,5,22187880,22187909,22187894,29
6705,3483075,5,23239817,23242154,23240985,2337
6706,3483076,1,10206372,10207201,10206786,829
6707,3483076,1,16472561,16472780,16472670,219
6708,3483076,1,23480951,23481116,23481033,165
6709,3483076,1,29639193,29639866,29639529,673
6710,3483076,2,6299192,6299234,6299213,42
6711,3483076,2,16732891,16734112,16733501,1221
6712,3483076,3,11107805,11108169,11107987,364
6713,3483076,5,5259909,5260168,5260038,259
6714,3483076,5,22634758,22635081,22634919,323
6715,3483076,5,23036214,23036442,23036328,228
6716,3483077,1,7839205,7840015,7839610,810
6717,3483077,1,19205462,19205750,19205606,288
6718,3483077,2,5049920,5050033,5049976,113
6719,3483077,2,6787865,6788063,6787964,198
6720,3483077,2,18313360,18313472,18313416,112
6721,3483077,3,5497055,5497212,5497133,157
6722,3483077,3,5498274,5499565,5498919,1291
6723,3483077,3,17693753,17694163,17693958,410
6724,3483077,3,22024871,22025161,22025016,290
6725,3483077,4,7769296,7769371,7769333,75
6726,3483077,5,1291,1886,1588,595
6727,3483077,5,5517745,5524623,5521184,6878
6728,3483077,5,25980326,25980661,25980493,335
6729,3483078,1,16851400,16851663,16851531,263
6730,3483078,2,4806175,4806437,4806306,262
6731,3483078,2,13866989,13867299,13867144,310
6732,3483078,3,9763678,9764240,9763959,562
6733,3483078,3,22377543,22377587,22377565,44
6734,3483078,4,5633540,5633733,5633636,193
6735,3483078,4,12351783,12352033,12351908,250
6736,3483078,5,1523822,1524294,1524058,472
6737,3483078,5,16527581,16528356,16527968,775
6738,3483078,5,26379666,26379748,26379707,82
6739,3483079,1,8486289,8486579,8486434,290
6740,3483079,1,13871709,13872157,13871933,448
6741,3483079,1,15995268,15995496,15995382,228
6742,3483079,1,22271240,22271748,22271494,508
6743,3483079,2,16817826,16818517,16818171,691
6744,3483079,3,4135715,4137367,4136541,1652
6745,3483079,3,9244867,9246341,9245604,1474
6746,3483079,3,22658178,22658749,22658463,571
6747,3483079,4,8822688,8822958,8822823,270
6748,3483079,4,16064740,16065505,16065122,765
6749,3483079,5,5770812,5770834,5770823,22
6750,3483080,1,11527882,11527962,11527922,80
6751,3483080,1,16134574,16135258,16134916,684
6752,3483080,2,8418980,8419263,8419121,283
6753,3483080,3,12127259,12127654,12127456,395
6754,3483080,4,7186940,7187028,7186984,88
6755,3483080,4,16421107,16421311,16421209,204
6756,3483080,5,1006890,1007232,1007061,342
6757,3483080,5,2477386,2477686,2477536,300
6758,3483080,5,24334507,24336110,24335308,1603
6759,3483080,5,26605333,26605666,26605499,333
6760,3483081,1,614273,617800,616036,3527
6761,3483081,1,16813152,16813871,16813511,719
6762,3483081,1,19975411,19975512,19975461,101
6763,3483081,2,9270967,9271360,9271163,393
6764,3483081,2,18033566,18034341,18033953,775
6765,3483081,3,10489162,10491136,10490149,1974
6766,3483081,4,5277365,5277462,5277413,97
6767,3483081,4,12428372,12430018,12429195,1646
6768,3483081,5,6992414,6992759,6992586,345
6769,3483081,5,19942264,19943379,19942821,1115
6770,3483082,1,3296981,3297585,3297283,604
6771,3483082,4,14325697,14330435,14328066,4738
6772,3483082,5,19590894,19590973,19590933,79
6773,3483082,5,25646145,25649906,25648025,3761
6774,3483084,1,16775649,16775665,16775657,16
6775,3483084,2,15238911,15240568,15239739,1657
6776,3483084,3,18397787,18398054,18397920,267
6777,3483084,4,9872412,9873421,9872916,1009
6778,3483084,5,10930451,10931193,10930822,742
6779,3483084,5,14560731,14561455,14561093,724
6780,3483085,3,3897642,3898641,3898141,999
6781,3483085,3,6808713,6810835,6809774,2122
6782,3483085,3,7774248,7774326,7774287,78
6783,3483085,3,9649820,9650994,9650407,1174
6784,3483085,3,19524333,19524483,19524408,150
6785,3483086,1,1955160,1956066,1955613,906
6786,3483086,1,17599405,17600396,17599900,991
6787,3483086,1,21409628,21409636,21409632,8
6788,3483086,1,26933948,26934069,26934008,121
6789,3483086,2,7639502,7639669,7639585,167
6790,3483086,2,14262648,14262932,14262790,284
6791,3483086,4,256287,257392,256839,1105
6792,3483086,4,2827490,2827534,2827512,44
6793,3483086,4,16688430,16689193,16688811,763
6794,3483086,4,18052729,18052800,18052764,71
6795,3483086,5,14931100,14933592,14932346,2492
6796,3483086,5,15261486,15263021,15262253,1535
6797,3483086,5,26525190,26525818,26525504,628
6798,3483087,1,1848017,1848450,1848233,433
6799,3483087,1,27389000,27389155,27389077,155
6800,3483087,1,28395866,28397923,28396894,2057
6801,3483087,2,321752,322119,321935,367
6802,3483087,3,3308562,3309058,3308810,496
6803,3483087,4,10339333,10340023,10339678,690
6804,3483087,5,1088147,1088451,1088299,304
6805,3483087,5,2975508,2976852,2976180,1344
6806,3483087,5,4152050,4152052,4152051,2
6807,3483087,5,9852257,9852480,9852368,223
6808,3483087,5,15367118,15367283,15367200,165
6809,3483087,5,22897465,22897863,22897664,398
6810,3483088,1,8351476,8352382,8351929,906
6811,3483088,1,18689252,18689376,18689314,124
6812,3483088,2,2089716,2089736,2089726,20
6813,3483088,2,14909012,14909745,14909378,733
6814,3483088,3,11161769,11163448,11162608,1679
6815,3483088,4,5446729,5447789,5447259,1060
6816,3483088,4,17368231,17371540,17369885,3309
6817,3483088,5,2784976,2786272,2785624,1296
6818,3483088,5,25684939,25685110,25685024,171
6819,3483089,1,4275624,4275679,4275651,55
6820,3483089,1,23050498,23050865,23050681,367
6821,3483089,1,24012717,24013546,24013131,829
6822,3483089,3,1359201,1359868,1359534,667
6823,3483089,4,14864217,14864972,14864594,755
6824,3483089,4,17411333,17411554,17411443,221
6825,3483090,1,19541613,19547255,19544434,5642
6826,3483090,2,14886914,14887437,14887175,523
6827,3483090,2,16241065,16242732,16241898,1667
6828,3483090,3,19499818,19499922,19499870,104
6829,3483090,4,10706203,10706242,10706222,39
6830,3483090,5,14707494,14708515,14708004,1021
6831,3483090,5,20551524,20553014,20552269,1490
6832,3483091,1,17962852,17963192,17963022,340
6833,3483091,1,28587778,28587867,28587822,89
6834,3483091,1,29741120,29742547,29741833,1427
6835,3483091,2,308840,309201,309020,361
6836,3483091,2,10446679,10446744,10446711,65
6837,3483091,3,15674945,15675382,15675163,437
6838,3483091,5,815209,815348,815278,139
6839,3483091,5,23398969,23399263,23399116,294
6840,3483091,5,26249956,26249971,26249963,15
6841,3483092,1,4488086,4489867,4488976,1781
6842,3483092,3,7174665,7175136,7174900,471
6843,3483092,3,11740757,11744206,11742481,3449
6844,3483092,3,17918667,17918893,17918780,226
6845,3483092,5,7396492,7397268,7396880,776
6846,3483092,5,8387051,8387092,8387071,41
6847,3483092,5,20906245,20906302,20906273,57
6848,3483093,1,25694839,25696065,25695452,1226
6849,3483093,2,193130,193895,193512,765
6850,3483093,2,2266975,2267046,2267010,71
6851,3483093,4,7344668,7345316,7344992,648
6852,3483093,5,9627713,9628025,9627869,312
6853,3483094,1,7654392,7654418,7654405,26
6854,3483094,2,16212818,16213046,16212932,228
6855,3483094,3,12365248,12365396,12365322,148
6856,3483094,3,14761655,14761735,14761695,80
6857,3483094,3,19467058,19469908,19468483,2850
6858,3483094,4,272128,272979,272553,851
6859,3483094,4,6316559,6316865,6316712,306
6860,3483094,4,7673551,7673605,7673578,54
6861,3483094,5,8194166,8194172,8194169,6
6862,3483094,5,19286123,19286875,19286499,752
6863,3483095,1,6183270,6183323,6183296,53
6864,3483095,1,9197577,9198263,9197920,686
6865,3483095,1,12734859,12734885,12734872,26
6866,3483095,1,28678490,28678743,28678616,253
6867,3483095,2,2323827,2323853,2323840,26
6868,3483095,2,13892779,13892917,13892848,138
6869,3483095,3,9819590,9819945,9819767,355
6870,3483095,4,412126,412959,412542,833
6871,3483095,4,11390004,11390102,11390053,98
6872,3483095,4,14022071,14022080,14022075,9
6873,3483095,5,10610748,10611001,10610874,253
6874,3483095,5,18077584,18077796,18077690,212
6875,3483095,5,25641662,25642299,25641980,637
6876,3483096,1,17823977,17824290,17824133,313
6877,3483096,1,26539975,26540023,26539999,48
6878,3483096,2,1419881,1420023,1419952,142
6879,3483096,2,6609006,6609009,6609007,3
6880,3483096,2,18605191,18606226,18605708,1035
6881,3483096,3,15562600,15562644,15562622,44
6882,3483096,4,1569526,1570269,1569897,743
6883,3483096,4,8056746,8056982,8056864,236
6884,3483097,1,8081087,8081190,8081138,103
6885,3483097,1,19690919,19691145,19691032,226
6886,3483097,2,348823,348842,348832,19
6887,3483097,2,8144473,8147480,8145976,3007
6888,3483097,3,7631483,7631723,7631603,240
6889,3483097,4,10974394,10974495,10974444,101
6890,3483098,1,11172927,11173110,11173018,183
6891,3483098,1,22152072,22152394,22152233,322
6892,3483098,2,18658493,18661555,18660024,3062
6893,3483098,4,852573,853530,853051,957
6894,3483098,4,7088956,7090837,7089896,1881
6895,3483098,4,10110408,10111076,10110742,668
6896,3483098,5,10222410,10222483,10222446,73
6897,3483098,5,22191553,22191807,22191680,254
6898,3483099,1,89553,90571,90062,1018
6899,3483099,1,11216157,11216496,11216326,339
6900,3483099,2,13489627,13490550,13490088,923
6901,3483099,3,5824048,5825150,5824599,1102
6902,3483099,3,15906005,15906538,15906271,533
6903,3483099,4,6048415,6048436,6048425,21
6904,3483099,4,17448805,17451702,17450253,2897
6905,3483100,1,30417499,30417616,30417557,117
6906,3483100,2,10774695,10774703,10774699,8
6907,3483100,3,10779716,10779718,10779717,2
6908,3483100,4,6868331,6869055,6868693,724
6909,3483100,4,14973079,14973544,14973311,465
6910,3483100,5,9156888,9157022,9156955,134
6911,3483100,5,26253943,26254698,26254320,755
6912,3483101,1,11543667,11545171,11544419,1504
6913,3483101,1,12607581,12607954,12607767,373
6914,3483101,2,8248011,8248546,8248278,535
6915,3483101,2,12123772,12124196,12123984,424
6916,3483101,3,17949014,17949721,17949367,707
6917,3483101,4,4802763,4802871,4802817,108
6918,3483101,4,14976121,14976350,14976235,229
6919,3483101,5,14526374,14526623,14526498,249
6920,3483101,5,23756983,23757052,23757017,69
6921,3483102,2,1603729,1604241,1603985,512
6922,3483102,3,18521246,18521973,18521609,727
6923,3483102,4,6402661,6402710,6402685,49
6924,3483102,4,11428587,11428947,11428767,360
6925,3483102,5,22925057,22928299,22926678,3242
6926,3483102,5,25216085,25216315,25216200,230
6927,3483103,1,8106156,8106192,8106174,36
6928,3483103,1,29761025,29761982,29761503,957
6929,3483103,2,359866,360213,360039,347
6930,3483103,2,6007059,6007692,6007375,633
6931,3483103,4,334266,334652,334459,386
6932,3483103,4,7806980,7807771,7807375,791
6933,3483104,2,7604485,7604704,7604594,219
6934,3483104,2,12963632,12964848,12964240,1216
6935,3483104,4,364263,364286,364274,23
6936,3483104,4,9173177,9173206,9173191,29
6937,3483104,5,169845,170069,169957,224
6938,3483104,5,2736754,2737189,2736971,435
6939,3483104,5,13771616,13771680,13771648,64
6940,3483104,5,21626125,21626369,21626247,244
6941,3483105,1,8026803,8026936,8026869,133
6942,3483105,1,8165510,8167473,8166491,1963
6943,3483105,2,9263705,9263847,9263776,142
6944,3483105,2,18512727,18512914,18512820,187
6945,3483105,3,9026908,9028088,9027498,1180
6946,3483105,4,5710390,5710434,5710412,44
6947,3483105,5,2621008,2621630,2621319,622
6948,3483105,5,6830772,6831253,6831012,481
6949,3483107,1,9231622,9231725,9231673,103
6950,3483107,1,17165864,17165999,17165931,135
6951,3483107,2,855911,855992,855951,81
6952,3483107,2,8928950,8929847,8929398,897
6953,3483107,2,18746514,18746722,18746618,208
6954,3483107,3,6796033,6796060,6796046,27
6955,3483107,5,2566740,2569312,2568026,2572
6956,3483107,5,8340467,8340571,8340519,104
6957,3483108,1,22809060,22810794,22809927,1734
6958,3483108,1,27599362,27599504,27599433,142
6959,3483108,2,8921084,8921257,8921170,173
6960,3483108,3,2543384,2545721,2544552,2337
6961,3483108,3,8037698,8038132,8037915,434
6962,3483108,4,5367784,5368132,5367958,348
6963,3483108,5,1832199,1833955,1833077,1756
6964,3483108,5,7960364,7961509,7960936,1145
6965,3483108,5,8813408,8816254,8814831,2846
6966,3483109,1,4039186,4039209,4039197,23
6967,3483109,1,27535781,27535845,27535813,64
6968,3483109,1,30415213,30416373,30415793,1160
6969,3483109,2,9249552,9250261,9249906,709
6970,3483109,3,11192987,11193929,11193458,942
6971,3483109,3,11746300,11746371,11746335,71
6972,3483109,4,9164256,9164524,9164390,268
6973,3483109,5,9002266,9002331,9002298,65
6974,3483109,5,26393660,26393929,26393794,269
6975,3483110,1,12686102,12687068,12686585,966
6976,3483110,2,1927287,1927452,1927369,165
6977,3483110,2,18528032,18530558,18529295,2526
6978,3483110,3,1094460,1094604,1094532,144
6979,3483110,4,6144558,6144711,6144634,153
6980,3483110,5,14385029,14517859,14451444,132830
6981,3483110,5,25156325,25156857,25156591,532
6982,3483111,1,11109001,11109050,11109025,49
6983,3483111,1,29856667,29857341,29857004,674
6984,3483111,2,271762,272157,271959,395
6985,3483111,2,18737133,18738334,18737733,1201
6986,3483111,3,6869836,6869961,6869898,125
6987,3483111,3,10647625,10647661,10647643,36
6988,3483111,3,18228817,18229046,18228931,229
6989,3483111,4,4890355,4890411,4890383,56
6990,3483111,4,10962256,10962289,10962272,33
6991,3483111,5,9671516,9672346,9671931,830
6992,3483112,1,6877967,6879810,6878888,1843
6993,3483112,1,7873667,7874950,7874308,1283
6994,3483112,1,23265002,23266080,23265541,1078
6995,3483112,1,23672269,23672996,23672632,727
6996,3483112,2,10410517,10410811,10410664,294
6997,3483112,5,7128699,7130053,7129376,1354
6998,3483112,5,21320450,21320458,21320454,8
6999,3483113,2,9733116,9733250,9733183,134
7000,3483113,3,10952006,10952335,10952170,329
7001,3483113,5,568761,569969,569365,1208
7002,3483113,5,9040140,9040418,9040279,278
7003,3483114,1,7500412,7500721,7500566,309
7004,3483114,1,8714506,8714544,8714525,38
7005,3483114,1,26055875,26056015,26055945,140
7006,3483114,3,16924683,16924998,16924840,315
7007,3483114,4,6928844,6929713,6929278,869
7008,3483114,4,8812604,8814442,8813523,1838
7009,3483114,4,17302219,17303775,17302997,1556
7010,3483114,5,10216314,10216400,10216357,86
7011,3483115,1,8178861,8180027,8179444,1166
7012,3483115,1,26353666,26353759,26353712,93
7013,3483115,3,22917804,22917926,22917865,122
7014,3483115,4,1055208,1056372,1055790,1164
7015,3483115,4,8467152,8467510,8467331,358
7016,3483116,1,10257567,10262630,10260098,5063
7017,3483116,1,25184483,25188470,25186476,3987
7018,3483116,3,17543066,17543268,17543167,202
7019,3483116,4,7761773,7762057,7761915,284
7020,3483116,5,5671132,5671161,5671146,29
7021,3483118,1,1575536,1576310,1575923,774
7022,3483118,1,17328318,17328449,17328383,131
7023,3483118,2,6586625,6609006,6597815,22381
7024,3483118,2,15592386,15593630,15593008,1244
7025,3483118,3,16683602,16683831,16683716,229
7026,3483118,3,18200382,18200800,18200591,418
7027,3483118,5,1299315,1299745,1299530,430
7028,3483118,5,16034755,16035253,16035004,498
7029,3483119,1,30416501,30416591,30416546,90
7030,3483119,2,17684713,17684850,17684781,137
7031,3483119,3,1489689,1490461,1490075,772
7032,3483119,3,9719521,9720270,9719895,749
7033,3483119,3,17082089,17082550,17082319,461
7034,3483119,3,21674955,21683115,21679035,8160
7035,3483119,4,5646362,5646454,5646408,92
7036,3483119,5,8992808,8993152,8992980,344
7037,3483120,1,9231725,9232389,9232057,664
7038,3483120,1,27536367,27536383,27536375,16
7039,3483120,3,3813760,3816937,3815348,3177
7040,3483120,3,7380175,7380309,7380242,134
7041,3483121,1,11118955,11119152,11119053,197
7042,3483121,1,11571280,11572413,11571846,1133
7043,3483121,2,15570756,15571024,15570890,268
7044,3483121,4,6540169,6542479,6541324,2310
7045,3483121,4,7312102,7312561,7312331,459
7046,3483121,5,22125250,22125305,22125277,55
7047,3483122,1,4509650,4509677,4509663,27
7048,3483122,1,9847451,9847834,9847642,383
7049,3483122,1,21084911,21085708,21085309,797
7050,3483122,2,6654362,6654522,6654442,160
7051,3483122,2,9762114,9762294,9762204,180
7052,3483122,2,17715300,17716436,17715868,1136
7053,3483122,4,8711179,8711302,8711240,123
7054,3483122,4,17651244,17651646,17651445,402
7055,3483122,5,1262369,1262910,1262639,541
7056,3483122,5,8167834,8173273,8170553,5439
7057,3483122,5,25771702,25771889,25771795,187
7058,3483123,1,4457184,4457488,4457336,304
7059,3483123,1,9811149,9811779,9811464,630
7060,3483123,1,21113303,21113444,21113373,141
7061,3483123,2,6639639,6639767,6639703,128
7062,3483123,2,9698461,9700065,9699263,1604
7063,3483123,2,17718832,17719057,17718944,225
7064,3483123,4,8720934,8720944,8720939,10
7065,3483123,4,17638303,17639024,17638663,721
7066,3483123,5,1253220,1254728,1253974,1508
7067,3483123,5,8237742,8238727,8238234,985
7068,3483123,5,25771702,25771889,25771795,187
7069,3483124,1,11830449,11830560,11830504,111
7070,3483124,3,4730783,4731548,4731165,765
7071,3483124,3,18576295,18576751,18576523,456
7072,3483124,4,6119579,6119628,6119603,49
7073,3483124,4,17301506,17301802,17301654,296
7074,3483124,5,7867732,7867989,7867860,257
7075,3483125,1,8727222,8727332,8727277,110
7076,3483125,1,21105252,21106524,21105888,1272
7077,3483125,1,30342365,30342936,30342650,571
7078,3483125,2,7220748,7220957,7220852,209
7079,3483125,3,7923039,7923143,7923091,104
7080,3483125,3,8554100,8554208,8554154,108
7081,3483125,4,5424572,5425362,5424967,790
7082,3483125,5,15864467,15864531,15864499,64
7083,3483125,5,21134197,21134489,21134343,292
7084,3483126,1,30085859,30086141,30086000,282
7085,3483126,2,8228794,8229583,8229188,789
7086,3483126,3,2284317,2284367,2284342,50
7087,3483126,3,12629708,12629974,12629841,266
7088,3483126,3,17534003,17534669,17534336,666
7089,3483126,4,1272502,1272732,1272617,230
7090,3483126,4,6832036,6832169,6832102,133
7091,3483126,5,4205876,4214223,4210049,8347
7092,3483126,5,15317553,15317699,15317626,146
7093,3483126,5,22521424,22521936,22521680,512
7094,3483127,2,7686855,7686933,7686894,78
7095,3483128,1,5134603,5135240,5134921,637
7096,3483128,1,26684976,26685700,26685338,724
7097,3483128,2,7679367,7679537,7679452,170
7098,3483128,3,2513066,2513581,2513323,515
7099,3483128,3,7778475,7778512,7778493,37
7100,3483128,4,5347190,5347434,5347312,244
7101,3483128,5,8583225,8583258,8583241,33
7102,3483128,5,19848953,19849153,19849053,200
7103,3483129,1,11844228,11844819,11844523,591
7104,3483129,1,22970466,22970771,22970618,305
7105,3483129,1,23758214,23758556,23758385,342
7106,3483129,2,2112678,2117860,2115269,5182
7107,3483129,2,11953238,11954013,11953625,775
7108,3483129,2,18340693,18340962,18340827,269
7109,3483129,3,4541491,4541611,4541551,120
7110,3483129,3,22653241,22653310,22653275,69
7111,3483129,4,8416781,8418315,8417548,1534
7112,3483130,2,7277653,7277975,7277814,322
7113,3483130,3,11096186,11096347,11096266,161
7114,3483130,3,15990255,15991375,15990815,1120
7115,3483130,4,5454493,5454736,5454614,243
7116,3483130,5,1479569,1479941,1479755,372
7117,3483130,5,21106110,21106893,21106501,783
7118,3483131,1,29873351,29874170,29873760,819
7119,3483131,2,11837378,11837734,11837556,356
7120,3483131,3,1429047,1433139,1431093,4092
7121,3483131,3,10437230,10437443,10437336,213
7122,3483131,4,7748377,7748683,7748530,306
7123,3483131,4,17745370,17746499,17745934,1129
7124,3483131,5,9378963,9379892,9379427,929
7125,3483131,5,21938383,21938622,21938502,239
7126,3483132,1,3859170,3859256,3859213,86
7127,3483132,1,10123184,10126871,10125027,3687
7128,3483132,1,13610282,13610679,13610480,397
7129,3483132,2,1840733,1840739,1840736,6
7130,3483132,2,1845047,1845325,1845186,278
7131,3483132,2,17042221,17042335,17042278,114
7132,3483132,3,9493320,9494117,9493718,797
7133,3483132,4,7953608,7954295,7953951,687
7134,3483132,5,8978309,8981546,8979927,3237
7135,3483132,5,16647680,16647690,16647685,10
7136,3483132,5,25937178,25938696,25937937,1518
7137,3483133,1,857623,858097,857860,474
7138,3483133,2,7299291,7299841,7299566,550
7139,3483133,2,18812647,18814015,18813331,1368
7140,3483133,3,1540731,1540738,1540734,7
7141,3483133,5,2141753,2143441,2142597,1688
7142,3483134,1,26664161,26664455,26664308,294
7143,3483134,3,15778702,15778782,15778742,80
7144,3483134,5,9164923,9171342,9168132,6419
7145,3483134,5,21313270,21313307,21313288,37
7146,3483135,1,11214477,11214679,11214578,202
7147,3483135,3,4550866,4553041,4551953,2175
7148,3483135,3,8170178,8170188,8170183,10
7149,3483135,4,7608082,7608190,7608136,108
7150,3483135,4,9656651,9656856,9656753,205
7151,3483135,5,9653179,9653670,9653424,491
7152,3483136,1,28960738,28963182,28961960,2444
7153,3483136,3,8123099,8123236,8123167,137
7154,3483136,4,6192278,6192568,6192423,290
7155,3483136,4,14127359,14128101,14127730,742
7156,3483136,5,8216971,8218493,8217732,1522
7157,3483137,1,23530143,23530664,23530403,521
7158,3483137,1,29360547,29360928,29360737,381
7159,3483137,2,6713944,6714388,6714166,444
7160,3483137,2,17696169,17696367,17696268,198
7161,3483137,4,6915742,6916232,6915987,490
7162,3483137,4,10829708,10830201,10829954,493
7163,3483137,4,16830482,16831728,16831105,1246
7164,3483137,5,26595887,26597870,26596878,1983
7165,3483138,1,11827897,11828258,11828077,361
7166,3483138,2,8412160,8412801,8412480,641
7167,3483138,3,19605131,19605423,19605277,292
7168,3483138,4,12372291,12373945,12373118,1654
7169,3483138,5,9046830,9049962,9048396,3132
7170,3483138,5,21856462,21856728,21856595,266
7171,3483139,1,21850302,21850332,21850317,30
7172,3483139,1,23648417,23649301,23648859,884
7173,3483139,2,7059137,7059765,7059451,628
7174,3483139,3,8201560,8202588,8202074,1028
7175,3483139,4,7305312,7305348,7305330,36
7176,3483139,4,12824175,12824732,12824453,557
7177,3483139,4,17674266,17675262,17674764,996
7178,3483139,5,14285,14442,14363,157
7179,3483139,5,14853688,14854335,14854011,647
7180,3483139,5,22008596,22009746,22009171,1150
7181,3483139,5,24644142,24644987,24644564,845
7182,3483140,1,1833212,1835198,1834205,1986
7183,3483140,1,18908099,18908304,18908201,205
7184,3483140,2,5671351,5672654,5672002,1303
7185,3483140,3,22724402,22725382,22724892,980
7186,3483140,4,10137589,10137766,10137677,177
7187,3483140,4,11811903,11812062,11811982,159
7188,3483140,5,1139548,1140076,1139812,528
7189,3483140,5,22069534,22070258,22069896,724
7190,3483141,1,6875158,6875633,6875395,475
7191,3483141,1,12485000,12485833,12485416,833
7192,3483141,2,104913,105236,105074,323
7193,3483141,2,2112678,2114785,2113731,2107
7194,3483141,3,17551190,17551986,17551588,796
7195,3483141,3,20602120,20603229,20602674,1109
7196,3483141,4,8545319,8545772,8545545,453
7197,3483141,4,17515188,17515656,17515422,468
7198,3483141,5,9292599,9292644,9292621,45
7199,3483141,5,25789137,25789269,25789203,132
7200,3483142,1,6643397,6643505,6643451,108
7201,3483142,2,12356960,12362096,12359528,5136
7202,3483142,3,17593325,17594239,17593782,914
7203,3483142,4,918135,918393,918264,258
7204,3483143,1,24761629,24763121,24762375,1492
7205,3483143,3,17604752,17604809,17604780,57
7206,3483143,4,6112892,6112945,6112918,53
7207,3483143,4,8978439,8979411,8978925,972
7208,3483143,5,8532203,8532510,8532356,307
7209,3483144,1,9485820,9486668,9486244,848
7210,3483144,1,11203087,11204937,11204012,1850
7211,3483144,1,24017845,24018041,24017943,196
7212,3483144,3,1730108,1730642,1730375,534
7213,3483144,4,5427231,5427850,5427540,619
7214,3483144,4,9240644,9241336,9240990,692
7215,3483144,5,10207431,10207573,10207502,142
7216,3483144,5,21804520,21805297,21804908,777
7217,3483145,1,7975171,7977159,7976165,1988
7218,3483145,1,25165293,25165745,25165519,452
7219,3483145,2,12296058,12296776,12296417,718
7220,3483145,3,10039257,10039373,10039315,116
7221,3483145,4,5640821,5641241,5641031,420
7222,3483145,5,15323236,15323880,15323558,644
7223,3483145,5,16385472,16385625,16385548,153
7224,3483146,1,8293428,8294020,8293724,592
7225,3483146,1,19901375,19902750,19902062,1375
7226,3483146,2,2301197,2301885,2301541,688
7227,3483146,2,10809163,10810665,10809914,1502
7228,3483146,3,23341571,23342070,23341820,499
7229,3483146,4,5320091,5320616,5320353,525
7230,3483146,5,7869089,7869243,7869166,154
7231,3483146,5,9969058,9969375,9969216,317
7232,3483146,5,19106577,19107159,19106868,582
7233,3483147,2,2099500,2099643,2099571,143
7234,3483147,2,7912160,7912318,7912239,158
7235,3483147,3,16863471,16863572,16863521,101
7236,3483147,5,17908804,17909592,17909198,788
7237,3483148,1,10122436,10123184,10122810,748
7238,3483148,2,2301969,2301997,2301983,28
7239,3483148,4,133129,133527,133328,398
7240,3483148,4,10078419,10078997,10078708,578
7241,3483148,5,6521982,6523118,6522550,1136
7242,3483148,5,10631795,10631891,10631843,96
7243,3483149,1,7819181,7819562,7819371,381
7244,3483149,1,20368762,20369994,20369378,1232
7245,3483149,2,1380248,1381387,1380817,1139
7246,3483149,2,11797697,11798291,11797994,594
7247,3483149,3,3507570,3508927,3508248,1357
7248,3483149,3,17584781,17587655,17586218,2874
7249,3483149,3,22411492,22413880,22412686,2388
7250,3483149,4,16913762,16913823,16913792,61
7251,3483149,5,7486894,7487272,7487083,378
7252,3483149,5,15500244,15501710,15500977,1466
7253,3483150,1,12487182,12488202,12487692,1020
7254,3483150,1,23108191,23108249,23108220,58
7255,3483150,2,6700152,6700432,6700292,280
7256,3483150,2,15126931,15126939,15126935,8
7257,3483150,3,9340337,9340345,9340341,8
7258,3483150,3,10403175,10403357,10403266,182
7259,3483150,4,8382136,8382275,8382205,139
7260,3483150,4,9061023,9061044,9061033,21
7261,3483150,5,9457881,9458003,9457942,122
7262,3483150,5,16020899,16021109,16021004,210
7263,3483150,5,18960079,18960234,18960156,155
7264,3483150,5,26350663,26350913,26350788,250
7265,3483151,1,26080617,26080714,26080665,97
7266,3483151,2,1428194,1428239,1428216,45
7267,3483151,2,16372055,16372844,16372449,789
7268,3483151,2,17379283,17379476,17379379,193
7269,3483151,4,5497514,5502079,5499796,4565
7270,3483151,4,10927779,10927856,10927817,77
7271,3483151,5,7902320,7902871,7902595,551
7272,3483151,5,10101636,10101798,10101717,162
7273,3483151,5,21960238,21960250,21960244,12
7274,3483152,1,569241,569887,569564,646
7275,3483152,1,5840961,5841117,5841039,156
7276,3483152,1,16443663,16443813,16443738,150
7277,3483152,2,2927798,2928473,2928135,675
7278,3483152,2,6800934,6802479,6801706,1545
7279,3483152,3,12729594,12729705,12729649,111
7280,3483152,3,14752899,14753183,14753041,284
7281,3483152,4,287750,288020,287885,270
7282,3483152,4,7799460,7801212,7800336,1752
7283,3483152,4,12180831,12181161,12180996,330
7284,3483152,5,7169206,7169508,7169357,302
7285,3483152,5,7869566,7869609,7869587,43
7286,3483152,5,26451304,26451657,26451480,353
7287,3483153,1,3254519,3254723,3254621,204
7288,3483153,1,3933802,3933893,3933847,91
7289,3483153,1,20937899,20938275,20938087,376
7290,3483153,2,6777391,6777531,6777461,140
7291,3483153,2,16774686,16775062,16774874,376
7292,3483153,2,18575075,18575506,18575290,431
7293,3483153,3,6138734,6139115,6138924,381
7294,3483153,3,10358999,10359461,10359230,462
7295,3483153,4,13238820,13239875,13239347,1055
7296,3483153,5,3967029,3968137,3967583,1108
7297,3483153,5,8735363,8738214,8736788,2851
7298,3483153,5,21785947,21788524,21787235,2577
7299,3483153,5,23982141,23982187,23982164,46
7300,3483154,1,29771857,29772335,29772096,478
7301,3483154,2,689391,691445,690418,2054
7302,3483154,2,12579165,12579191,12579178,26
7303,3483154,2,19318955,19320501,19319728,1546
7304,3483154,3,11074551,11074602,11074576,51
7305,3483154,4,17327047,17328235,17327641,1188
7306,3483154,5,9313138,9313481,9313309,343
7307,3483154,5,9809671,9812475,9811073,2804
7308,3483154,5,25960659,25961748,25961203,1089
7309,3483155,1,10860971,10862678,10861824,1707
7310,3483155,1,19349011,19349610,19349310,599
7311,3483155,1,19861618,19865436,19863527,3818
7312,3483155,3,18839288,18839322,18839305,34
7313,3483155,5,5937557,5937840,5937698,283
7314,3483155,5,9898391,9898453,9898422,62
7315,3483155,5,18759334,18759872,18759603,538
7316,3483155,5,20212404,20212685,20212544,281
7317,3483156,2,12820697,12820741,12820719,44
7318,3483156,2,16850238,16850409,16850323,171
7319,3483156,3,5343127,5344480,5343803,1353
7320,3483156,3,19644397,19646239,19645318,1842
7321,3483156,4,6833400,6836105,6834752,2705
7322,3483156,5,2011170,2014249,2012709,3079
7323,3483156,5,21438721,21440453,21439587,1732
7324,3483157,1,614273,615954,615113,1681
7325,3483157,1,8119850,8120339,8120094,489
7326,3483157,2,2892830,2893347,2893088,517
7327,3483157,2,17709594,17710123,17709858,529
7328,3483157,4,10776156,10776662,10776409,506
7329,3483157,5,21311656,21311769,21311712,113
7330,3483158,1,13077108,13077389,13077248,281
7331,3483158,2,10410337,10410431,10410384,94
7332,3483158,2,19233038,19233086,19233062,48
7333,3483158,3,1215611,1215878,1215744,267
7334,3483158,3,15983643,15985760,15984701,2117
7335,3483158,4,6746198,6747019,6746608,821
7336,3483158,5,4726456,4727237,4726846,781
7337,3483159,1,8884690,8885151,8884920,461
7338,3483159,1,26742548,26745250,26743899,2702
7339,3483159,2,11099892,11100870,11100381,978
7340,3483159,2,18025158,18025694,18025426,536
7341,3483159,3,10034655,10035378,10035016,723
7342,3483159,3,16964614,16964946,16964780,332
7343,3483159,4,1196368,1196727,1196547,359
7344,3483159,4,12359342,12359969,12359655,627
7345,3483159,5,14889845,14890529,14890187,684
7346,3483159,5,17609173,17609695,17609434,522
7347,3483160,1,6097910,6098404,6098157,494
7348,3483160,1,12946629,12948960,12947794,2331
7349,3483160,2,6165180,6165260,6165220,80
7350,3483160,2,17426338,17428103,17427220,1765
7351,3483160,2,19063751,19063782,19063766,31
7352,3483160,3,20075102,20076088,20075595,986
7353,3483160,5,7723045,7724421,7723733,1376
7354,3483161,1,5595676,5596584,5596130,908
7355,3483161,1,17910586,17912288,17911437,1702
7356,3483161,2,2908708,2908958,2908833,250
7357,3483161,3,19842274,19843757,19843015,1483
7358,3483161,3,20678406,20679059,20678732,653
7359,3483161,4,11750149,11750773,11750461,624
7360,3483161,4,17565581,17566048,17565814,467
7361,3483161,5,18285285,18285694,18285489,409
7362,3483162,1,17860728,17862548,17861638,1820
7363,3483162,1,26425855,26426146,26426000,291
7364,3483162,1,28739915,28746408,28743161,6493
7365,3483162,1,30413034,30413136,30413085,102
7366,3483162,2,10392243,10392801,10392522,558
7367,3483162,3,7812273,7812839,7812556,566
7368,3483162,4,10470973,10471155,10471064,182
7369,3483162,4,17357787,17358936,17358361,1149
7370,3483162,5,13703210,13703282,13703246,72
7371,3483162,5,23058586,23058969,23058777,383
7372,3483163,1,8864629,8864944,8864786,315
7373,3483163,1,23786492,23787062,23786777,570
7374,3483163,2,9205269,9205624,9205446,355
7375,3483163,2,9910587,9910825,9910706,238
7376,3483163,3,2501492,2502882,2502187,1390
7377,3483163,4,18047337,18047788,18047562,451
7378,3483163,5,6441121,6441210,6441165,89
7379,3483163,5,15621643,15622730,15622186,1087
7380,3483163,5,18914918,18914919,18914918,1
7381,3483164,1,7195448,7196105,7195776,657
7382,3483164,1,9459186,9459985,9459585,799
7383,3483164,2,11431850,11434134,11432992,2284
7384,3483164,2,12942617,12942827,12942722,210
7385,3483164,3,17762252,17762991,17762621,739
7386,3483164,4,12493763,12494405,12494084,642
7387,3483164,4,13293059,13293060,13293059,1
7388,3483164,5,4116372,4116644,4116508,272
7389,3483164,5,18140703,18141420,18141061,717
7390,3483165,1,12644135,12644139,12644137,4
7391,3483165,1,28073655,28074288,28073971,633
7392,3483165,2,4806175,4806437,4806306,262
7393,3483165,3,2321112,2321665,2321388,553
7394,3483165,3,16967866,16967909,16967887,43
7395,3483165,4,6743451,6743509,6743480,58
7396,3483166,1,19150597,19150661,19150629,64
7397,3483166,1,20059502,20060281,20059891,779
7398,3483166,3,9496157,9497318,9496737,1161
7399,3483166,4,924860,925681,925270,821
7400,3483166,4,17427682,17429322,17428502,1640
7401,3483166,5,15214772,15216275,15215523,1503
7402,3483166,5,25078675,25079001,25078838,326
7403,3483167,2,363492,365116,364304,1624
7404,3483167,2,7274920,7275141,7275030,221
7405,3483167,2,11966391,11967217,11966804,826
7406,3483167,3,848845,848958,848901,113
7407,3483167,3,17610231,17610322,17610276,91
7408,3483167,5,8794038,8794794,8794416,756
7409,3483168,1,173879,174816,174347,937
7410,3483168,1,26003001,26003849,26003425,848
7411,3483168,2,10045018,10045259,10045138,241
7412,3483168,3,16469319,16469332,16469325,13
7413,3483168,3,20732922,20733350,20733136,428
7414,3483168,4,10161110,10162487,10161798,1377
7415,3483168,4,13854566,13855732,13855149,1166
7416,3483168,5,18517542,18523138,18520340,5596
7417,3483168,5,24445363,24445448,24445405,85
7418,3483169,2,9515617,9515810,9515713,193
7419,3483169,3,7221013,7221282,7221147,269
7420,3483169,3,15501728,15501729,15501728,1
7421,3483169,3,18834592,18835102,18834847,510
7422,3483169,4,5170173,5170588,5170380,415
7423,3483169,5,14896862,14896933,14896897,71
7424,3483170,1,1426755,1428491,1427623,1736
7425,3483170,1,11100280,11101365,11100822,1085
7426,3483170,1,25673384,25675010,25674197,1626
7427,3483170,2,18712412,18713070,18712741,658
7428,3483170,3,18554885,18554911,18554898,26
7429,3483170,4,10289158,10289165,10289161,7
7430,3483170,5,1408979,1411582,1410280,2603
7431,3483170,5,15657724,15657739,15657731,15
7432,3483171,1,5139750,5143204,5141477,3454
7433,3483171,1,5868620,5869111,5868865,491
7434,3483171,1,6772314,6772489,6772401,175
7435,3483171,1,7296004,7296171,7296087,167
7436,3483171,1,9558285,9559074,9558679,789
7437,3483171,1,10549598,10550106,10549852,508
7438,3483171,1,12256080,12256672,12256376,592
7439,3483171,1,17240548,17240607,17240577,59
7440,3483171,1,19078656,19078834,19078745,178
7441,3483171,1,19485248,19485898,19485573,650
7442,3483171,1,20006392,20006475,20006433,83
7443,3483171,1,20968710,20970351,20969530,1641
7444,3483171,1,25068425,25068854,25068639,429
7445,3483171,1,26326327,26327090,26326708,763
7446,3483171,1,26629025,26629607,26629316,582
7447,3483171,1,27738090,27738198,27738144,108
7448,3483171,1,29725947,29726516,29726231,569
7449,3483171,2,1937513,1937579,1937546,66
7450,3483171,2,2381962,2382102,2382032,140
7451,3483171,2,5651267,5651560,5651413,293
7452,3483171,2,9075625,9078216,9076920,2591
7453,3483171,2,9716743,9717227,9716985,484
7454,3483171,2,10195368,10195381,10195374,13
7455,3483171,2,12996046,12996073,12996059,27
7456,3483171,2,13235611,13235765,13235688,154
7457,3483171,2,13854971,13855367,13855169,396
7458,3483171,2,15563503,15563663,15563583,160
7459,3483171,3,1826973,1828816,1827894,1843
7460,3483171,3,2513581,2513712,2513646,131
7461,3483171,3,3043721,3043734,3043727,13
7462,3483171,3,5595403,5595553,5595478,150
7463,3483171,3,9340764,9340861,9340812,97
7464,3483171,3,10302406,10302409,10302407,3
7465,3483171,3,15432347,15432350,15432348,3
7466,3483171,3,16319207,16319211,16319209,4
7467,3483171,3,16731780,16731797,16731788,17
7468,3483171,3,17347430,17347514,17347472,84
7469,3483171,3,18246753,18248005,18247379,1252
7470,3483171,3,19702681,19702752,19702716,71
7471,3483171,3,22364288,22364834,22364561,546
7472,3483171,3,23386415,23386503,23386459,88
7473,3483171,4,459662,459856,459759,194
7474,3483171,4,1640316,1640333,1640324,17
7475,3483171,4,2623663,2623834,2623748,171
7476,3483171,4,3370882,3371492,3371187,610
7477,3483171,4,4938176,4938226,4938201,50
7478,3483171,4,7246616,7247349,7246982,733
7479,3483171,4,7668387,7668689,7668538,302
7480,3483171,4,8087362,8087364,8087363,2
7481,3483171,4,8541083,8541175,8541129,92
7482,3483171,4,12885040,12885858,12885449,818
7483,3483171,4,15118202,15119477,15118839,1275
7484,3483171,4,18505894,18507588,18506741,1694
7485,3483171,5,3741484,3741886,3741685,402
7486,3483171,5,4730492,4732136,4731314,1644
7487,3483171,5,5255981,5256038,5256009,57
7488,3483171,5,7476840,7476949,7476894,109
7489,3483171,5,16890267,16890473,16890370,206
7490,3483171,5,17391050,17391110,17391080,60
7491,3483171,5,17801414,17801710,17801562,296
7492,3483171,5,19203891,19204299,19204095,408
7493,3483171,5,19621586,19621733,19621659,147
7494,3483171,5,20306186,20306369,20306277,183
7495,3483171,5,21320450,21320458,21320454,8
7496,3483171,5,21733844,21734548,21734196,704
7497,3483171,5,22658098,22659023,22658560,925
7498,3483172,1,8613296,8613638,8613467,342
7499,3483172,3,2513066,2513581,2513323,515
7500,3483172,3,17132069,17132089,17132079,20
7501,3483172,4,5854292,5855639,5854965,1347
7502,3483172,5,8386483,8386507,8386495,24
7503,3483172,5,9958807,9958891,9958849,84
7504,3483172,5,18808808,18808958,18808883,150
7505,3483173,1,16811035,16811036,16811035,1
7506,3483173,1,29499925,29500151,29500038,226
7507,3483173,2,15718436,15718479,15718457,43
7508,3483173,2,19607086,19607363,19607224,277
7509,3483173,3,10738478,10738583,10738530,105
7510,3483173,4,130310,131413,130861,1103
7511,3483173,4,17527541,17527563,17527552,22
7512,3483173,5,14725622,14727142,14726382,1520
7513,3483174,1,8943772,8944324,8944048,552
7514,3483174,1,16798893,16798946,16798919,53
7515,3483174,1,21419770,21420020,21419895,250
7516,3483174,3,2444719,2446431,2445575,1712
7517,3483174,3,10925265,10925325,10925295,60
7518,3483174,3,11648893,11648942,11648917,49
7519,3483174,4,842201,842771,842486,570
7520,3483174,5,4444178,4444229,4444203,51
7521,3483174,5,21023894,21024021,21023957,127
7522,3483175,1,18459911,18460225,18460068,314
7523,3483175,1,28936924,28937757,28937340,833
7524,3483175,2,12141856,12141898,12141877,42
7525,3483175,4,6191743,6192115,6191929,372
7526,3483175,4,13758444,13764990,13761717,6546
7527,3483175,5,1377075,1377230,1377152,155
7528,3483175,5,4929002,4934343,4931672,5341
7529,3483175,5,18619386,18620315,18619850,929
7530,3483176,1,178456,179175,178815,719
7531,3483176,2,16529556,16530300,16529928,744
7532,3483176,5,4764536,4764757,4764646,221
7533,3483176,5,18978240,18978476,18978358,236
7534,3483176,5,20220890,20221548,20221219,658
7535,3483176,5,24773765,24774510,24774137,745
7536,3483177,1,796861,797322,797091,461
7537,3483177,1,19209110,19210413,19209761,1303
7538,3483177,1,27131045,27131606,27131325,561
7539,3483177,2,81758,81886,81822,128
7540,3483177,2,2310345,2312714,2311529,2369
7541,3483177,2,6810782,6810947,6810864,165
7542,3483177,3,18923496,18923720,18923608,224
7543,3483177,4,1175670,1175715,1175692,45
7544,3483177,4,7627633,7631174,7629403,3541
7545,3483177,5,13749867,13750806,13750336,939
7546,3483178,1,456627,458079,457353,1452
7547,3483178,1,22726442,22727742,22727092,1300
7548,3483178,1,24254783,24255132,24254957,349
7549,3483178,2,113118,113155,113136,37
7550,3483178,2,12414849,12419551,12417200,4702
7551,3483178,2,12940503,12942617,12941560,2114
7552,3483178,3,7360257,7360738,7360497,481
7553,3483178,3,16680919,16681091,16681005,172
7554,3483178,3,21143526,21144288,21143907,762
7555,3483178,4,5435661,5435843,5435752,182
7556,3483178,4,7147054,7147141,7147097,87
7557,3483178,5,7980093,7980174,7980133,81
7558,3483178,5,23950340,23951013,23950676,673
7559,3483179,3,3449845,3449967,3449906,122
7560,3483180,2,6006328,6007059,6006693,731
7561,3483180,2,10615446,10615708,10615577,262
7562,3483180,2,18664431,18666022,18665226,1591
7563,3483180,3,19506189,19506306,19506247,117
7564,3483180,4,9436686,9436783,9436734,97
7565,3483180,5,5348774,5349278,5349026,504
7566,3483180,5,15970886,15972234,15971560,1348
7567,3483181,1,12937650,12937716,12937683,66
7568,3483181,1,23500786,23501264,23501025,478
7569,3483181,2,2230831,2230932,2230881,101
7570,3483181,2,12430524,12430924,12430724,400
7571,3483181,3,1005760,1005930,1005845,170
7572,3483181,3,9302618,9305911,9304264,3293
7573,3483181,4,6745253,6746198,6745725,945
7574,3483181,5,9378738,9378963,9378850,225
7575,3483181,5,21320277,21320395,21320336,118
7576,3483182,1,4900989,4901122,4901055,133
7577,3483182,1,11007413,11007436,11007424,23
7578,3483182,2,9693808,9694162,9693985,354
7579,3483182,3,642317,642487,642402,170
7580,3483182,3,3435095,3435552,3435323,457
7581,3483182,3,17535882,17535928,17535905,46
7582,3483182,5,9521937,9521996,9521966,59
7583,3483182,5,15705541,15705579,15705560,38
7584,3483182,5,26089734,26091261,26090497,1527
7585,3483183,1,7670315,7671368,7670841,1053
7586,3483183,1,18020071,18020308,18020189,237
7587,3483183,1,23524912,23525614,23525263,702
7588,3483183,2,12138097,12140462,12139279,2365
7589,3483183,2,18893727,18895270,18894498,1543
7590,3483183,3,69524,69844,69684,320
7591,3483183,3,3704218,3704851,3704534,633
7592,3483183,3,4748820,4750236,4749528,1416
7593,3483183,5,10087,14285,12186,4198
7594,3483183,5,6465995,6466254,6466124,259
7595,3483183,5,13938448,13939085,13938766,637
7596,3483183,5,24333602,24334507,24334054,905
7597,3483184,1,7480006,7481183,7480594,1177
7598,3483184,1,12698013,12699519,12698766,1506
7599,3483184,2,756595,757267,756931,672
7600,3483184,2,7283849,7284313,7284081,464
7601,3483184,2,11867001,11867041,11867021,40
7602,3483184,2,19194458,19194524,19194491,66
7603,3483184,3,7385690,7386738,7386214,1048
7604,3483184,3,16648622,16648643,16648632,21
7605,3483184,4,8386992,8387166,8387079,174
7606,3483184,4,10716389,10717058,10716723,669
7607,3483184,5,5218788,5218799,5218793,11
7608,3483184,5,26871263,26871569,26871416,306
7609,3483185,1,9164916,9166436,9165676,1520
7610,3483185,1,11822445,11822983,11822714,538
7611,3483185,2,992644,992674,992659,30
7612,3483185,2,6215552,6215789,6215670,237
7613,3483185,2,18415212,18415401,18415306,189
7614,3483185,3,17283354,17283906,17283630,552
7615,3483185,3,22363529,22363685,22363607,156
7616,3483185,4,9164610,9164730,9164670,120
7617,3483185,5,6832292,6832381,6832336,89
7618,3483185,5,15317553,15317699,15317626,146
7619,3483185,5,23081897,23081988,23081942,91
7620,3483186,1,4058769,4058922,4058845,153
7621,3483186,1,11162106,11162974,11162540,868
7622,3483186,1,11631099,11631118,11631108,19
7623,3483186,2,807021,808401,807711,1380
7624,3483186,3,9339676,9339903,9339789,227
7625,3483186,5,17107683,17108148,17107915,465
7626,3483187,1,1818723,1819235,1818979,512
7627,3483187,1,2694957,2695893,2695425,936
7628,3483187,1,4901255,4902678,4901966,1423
7629,3483187,1,12034423,12035738,12035080,1315
7630,3483187,2,6959762,6960043,6959902,281
7631,3483187,2,10353448,10353603,10353525,155
7632,3483187,3,22374979,22376196,22375587,1217
7633,3483187,4,5145640,5147232,5146436,1592
7634,3483188,2,14509167,14509223,14509195,56
7635,3483188,3,1440308,1440427,1440367,119
7636,3483188,3,11744542,11744926,11744734,384
7637,3483188,3,15957068,15957393,15957230,325
7638,3483188,4,7742307,7743305,7742806,998
7639,3483188,4,9365553,9366705,9366129,1152
7640,3483188,5,7045093,7046023,7045558,930
7641,3483188,5,10455483,10455664,10455573,181
7642,3483188,5,17690196,17690930,17690563,734
7643,3483188,5,21729645,21729791,21729718,146
7644,3483189,1,747822,748309,748065,487
7645,3483189,1,10370315,10370421,10370368,106
7646,3483189,1,23408055,23409540,23408797,1485
7647,3483189,2,2243035,2243797,2243416,762
7648,3483189,3,501122,501450,501286,328
7649,3483189,3,15550894,15551304,15551099,410
7650,3483189,4,6508259,6508432,6508345,173
7651,3483189,5,26748301,26748648,26748474,347
7652,3483190,1,165910,165930,165920,20
7653,3483190,1,24431873,24432467,24432170,594
7654,3483190,2,478358,479089,478723,731
7655,3483190,2,18534830,18535032,18534931,202
7656,3483190,3,16469451,16469512,16469481,61
7657,3483190,4,87323,88852,88087,1529
7658,3483190,4,8058563,8059216,8058889,653
7659,3483191,1,25497948,25498936,25498442,988
7660,3483191,2,447999,448275,448137,276
7661,3483191,3,9057051,9057487,9057269,436
7662,3483191,3,17452720,17452860,17452790,140
7663,3483191,5,7550810,7552283,7551546,1473
7664,3483191,5,8035827,8036417,8036122,590
7665,3483192,1,16481280,16482946,16482113,1666
7666,3483192,1,17942688,17942763,17942725,75
7667,3483192,2,16235993,16236771,16236382,778
7668,3483192,3,8946786,8946810,8946798,24
7669,3483192,4,11131655,11131703,11131679,48
7670,3483193,2,1060699,1061044,1060871,345
7671,3483193,2,9538444,9538803,9538623,359
7672,3483193,2,18627892,18627968,18627930,76
7673,3483193,3,8123236,8123295,8123265,59
7674,3483193,3,8553807,8554208,8554007,401
7675,3483193,3,18788464,18789568,18789016,1104
7676,3483193,3,19486588,19486663,19486625,75
7677,3483193,4,7670160,7670283,7670221,123
7678,3483193,5,452536,453096,452816,560
7679,3483193,5,15774098,15774149,15774123,51
7680,3483193,5,21321023,21323157,21322090,2134
7681,3483194,1,3887461,3887839,3887650,378
7682,3483194,1,11470065,11470158,11470111,93
7683,3483194,1,22827103,22828331,22827717,1228
7684,3483194,2,147111,149174,148142,2063
7685,3483194,2,8195637,8197211,8196424,1574
7686,3483194,2,14358148,14358346,14358247,198
7687,3483194,4,5565022,5565560,5565291,538
7688,3483194,4,10974495,10974531,10974513,36
7689,3483194,5,16881844,16882212,16882028,368
7690,3483194,5,17584826,17584964,17584895,138
7691,3483195,1,17320613,17321579,17321096,966
7692,3483195,1,27143884,27144326,27144105,442
7693,3483195,2,6233760,6233933,6233846,173
7694,3483195,3,7964708,7965661,7965184,953
7695,3483195,4,1533888,1534345,1534116,457
7696,3483195,4,13648714,13648792,13648753,78
7697,3483195,5,26514534,26514817,26514675,283
7698,3483196,1,30351698,30352018,30351858,320
7699,3483196,4,1466154,1466194,1466174,40
7700,3483196,4,10022021,10022203,10022112,182
7701,3483196,5,26916179,26916192,26916185,13
7702,3483197,1,21648639,21649492,21649065,853
7703,3483197,2,6035326,6036484,6035905,1158
7704,3483197,2,16811943,16811968,16811955,25
7705,3483197,4,5341750,5342103,5341926,353
7706,3483197,4,6144773,6144884,6144828,111
7707,3483197,4,15417154,15418825,15417989,1671
7708,3483197,5,8794038,8794642,8794340,604
7709,3483198,1,3623326,3625529,3624427,2203
7710,3483198,2,7089547,7090140,7089843,593
7711,3483198,2,12298889,12300124,12299506,1235
7712,3483198,3,1436828,1439723,1438275,2895
7713,3483198,3,7361705,7361987,7361846,282
7714,3483198,4,9930371,9930560,9930465,189
7715,3483199,1,12374515,12374919,12374717,404
7716,3483199,1,13142745,13143966,13143355,1221
7717,3483199,2,11728628,11728711,11728669,83
7718,3483199,2,13823499,13824107,13823803,608
7719,3483199,3,9770190,9770732,9770461,542
7720,3483199,3,19414482,19414581,19414531,99
7721,3483199,4,5932071,5932126,5932098,55
7722,3483199,4,6338656,6339105,6338880,449
7723,3483199,5,16203435,16204158,16203796,723
7724,3483199,5,18562399,18562514,18562456,115
7725,3483200,1,7964500,7964515,7964507,15
7726,3483200,1,16882638,16883211,16882924,573
7727,3483200,1,17768126,17770178,17769152,2052
7728,3483200,1,28864059,28868644,28866351,4585
7729,3483200,2,7219139,7219497,7219318,358
7730,3483200,3,8123331,8123602,8123466,271
7731,3483200,4,8608678,8609551,8609114,873
7732,3483200,5,428607,428962,428784,355
7733,3483200,5,17156605,17157093,17156849,488
7734,3483200,5,19138735,19140166,19139450,1431
7735,3483201,1,16268943,16269068,16269005,125
7736,3483201,1,19619514,19619558,19619536,44
7737,3483201,2,1682530,1682609,1682569,79
7738,3483201,2,19132301,19133332,19132816,1031
7739,3483201,4,6025688,6025835,6025761,147
7740,3483201,5,3191298,3192044,3191671,746
7741,3483201,5,7984257,7987792,7986024,3535
7742,3483202,1,12851652,12851794,12851723,142
7743,3483202,1,20106370,20107294,20106832,924
7744,3483202,2,418467,419004,418735,537
7745,3483202,2,15872018,15878790,15875404,6772
7746,3483202,3,20544926,20544969,20544947,43
7747,3483202,4,7407875,7412527,7410201,4652
7748,3483203,1,4779155,4779442,4779298,287
7749,3483203,1,8355199,8355480,8355339,281
7750,3483203,5,2201621,2201732,2201676,111
7751,3483203,5,18722677,18722958,18722817,281
7752,3483203,5,26004765,26004922,26004843,157
7753,3483204,1,10363027,10363697,10363362,670
7754,3483204,1,11117564,11117716,11117640,152
7755,3483204,2,7238376,7238510,7238443,134
7756,3483204,4,1023562,1026302,1024932,2740
7757,3483204,5,10430552,10430808,10430680,256
7758,3483205,1,7460987,7461275,7461131,288
7759,3483205,2,480350,480370,480360,20
7760,3483205,2,592611,592776,592693,165
7761,3483205,3,9192785,9194291,9193538,1506
7762,3483205,4,5457236,5457384,5457310,148
7763,3483205,4,9898854,9899940,9899397,1086
7764,3483205,5,7113724,7113890,7113807,166
7765,3483205,5,19581822,19583125,19582473,1303
7766,3483205,5,20771412,20771454,20771433,42
7767,3483206,1,2235436,2235506,2235471,70
7768,3483206,1,19615342,19618426,19616884,3084
7769,3483206,1,28193889,28194661,28194275,772
7770,3483206,2,6940627,6947892,6944259,7265
7771,3483206,2,7993245,7993420,7993332,175
7772,3483206,2,19066875,19066925,19066900,50
7773,3483206,3,1805727,1806089,1805908,362
7774,3483206,3,5812583,5813218,5812900,635
7775,3483206,3,12074400,12074417,12074408,17
7776,3483206,4,17535879,17536316,17536097,437
7777,3483206,5,3452750,3453040,3452895,290
7778,3483206,5,5137068,5137119,5137093,51
7779,3483206,5,24494190,24495234,24494712,1044
7780,3483207,2,2350736,2350818,2350777,82
7781,3483207,2,7312498,7313799,7313148,1301
7782,3483207,3,1349736,1349955,1349845,219
7783,3483207,4,7285374,7285536,7285455,162
7784,3483207,4,16645037,16645689,16645363,652
7785,3483207,5,570137,570270,570203,133
7786,3483207,5,20759255,20762914,20761084,3659
7787,3483207,5,21652503,21652699,21652601,196
7788,3483208,1,16132859,16133722,16133290,863
7789,3483208,1,23415454,23415926,23415690,472
7790,3483208,1,27142066,27143203,27142634,1137
7791,3483208,3,9834307,9834835,9834571,528
7792,3483208,4,1264510,1265949,1265229,1439
7793,3483208,4,7712697,7715529,7714113,2832
7794,3483208,5,15609377,15614958,15612167,5581
7795,3483209,1,3354275,3355616,3354945,1341
7796,3483209,1,23825705,23825729,23825717,24
7797,3483209,2,640843,641403,641123,560
7798,3483209,2,11758252,11760079,11759165,1827
7799,3483209,3,2375828,2376616,2376222,788
7800,3483209,3,15973550,15974366,15973958,816
7801,3483209,3,21741614,21745308,21743461,3694
7802,3483209,4,5378596,5379241,5378918,645
7803,3483209,5,7610375,7611447,7610911,1072
7804,3483209,5,14773316,14773394,14773355,78
7805,3483209,5,17730443,17731537,17730990,1094
7806,3483210,1,4754352,4756914,4755633,2562
7807,3483210,1,18384374,18388169,18386271,3795
7808,3483210,2,15879515,15879618,15879566,103
7809,3483210,3,11648433,11648942,11648687,509
7810,3483210,3,22176452,22176959,22176705,507
7811,3483210,4,8062081,8062144,8062112,63
7812,3483210,4,17683651,17684117,17683884,466
7813,3483210,5,8809047,8810455,8809751,1408
7814,3483210,5,17642596,17643691,17643143,1095
7815,3483211,1,6904935,6905943,6905439,1008
7816,3483211,1,23221706,23222391,23222048,685
7817,3483211,2,17881666,17887845,17884755,6179
7818,3483211,3,10061432,10062822,10062127,1390
7819,3483211,4,585377,586085,585731,708
7820,3483211,4,7782837,7782856,7782846,19
7821,3483211,5,940266,940440,940353,174
7822,3483211,5,17129126,17129152,17129139,26
7823,3483211,5,25162532,25162835,25162683,303
7824,3483212,1,17067152,17067813,17067482,661
7825,3483212,1,24810514,24810546,24810530,32
7826,3483212,2,2295426,2295684,2295555,258
7827,3483212,2,7984398,7985077,7984737,679
7828,3483212,4,10671276,10671827,10671551,551
7829,3483212,5,9010804,9011642,9011223,838
7830,3483212,5,14531573,14532288,14531930,715
7831,3483213,1,7383370,7384716,7384043,1346
7832,3483213,1,28918444,28918481,28918462,37
7833,3483213,2,8798729,8799925,8799327,1196
7834,3483213,2,12797280,12797319,12797299,39
7835,3483213,3,9037444,9037985,9037714,541
7836,3483213,3,9473935,9473987,9473961,52
7837,3483213,4,12411540,12412601,12412070,1061
7838,3483214,1,9019621,9019815,9019718,194
7839,3483214,1,18426030,18426350,18426190,320
7840,3483214,1,19346638,19346656,19346647,18
7841,3483214,2,16644799,16645503,16645151,704
7842,3483214,3,6847204,6847361,6847282,157
7843,3483214,4,6574954,6574964,6574959,10
7844,3483214,5,24965860,24966014,24965937,154
7845,3483215,1,10148324,10148335,10148329,11
7846,3483215,1,18763217,18765454,18764335,2237
7847,3483215,2,6889060,6889523,6889291,463
7848,3483215,4,9601060,9601206,9601133,146
7849,3483216,1,2665295,2665738,2665516,443
7850,3483216,1,11945594,11945606,11945600,12
7851,3483216,1,26472579,26473078,26472828,499
7852,3483216,2,1191167,1191228,1191197,61
7853,3483216,2,15121267,15122184,15121725,917
7854,3483216,4,7366099,7366247,7366173,148
7855,3483216,5,2102281,2104515,2103398,2234
7856,3483216,5,18152788,18154292,18153540,1504
7857,3483216,5,25032814,25038250,25035532,5436
7858,3483217,1,22198105,22198176,22198140,71
7859,3483217,1,28413281,28413929,28413605,648
7860,3483217,2,12495810,12495920,12495865,110
7861,3483217,2,13829762,13830035,13829898,273
7862,3483217,3,1335433,1338569,1337001,3136
7863,3483217,3,9501833,9502055,9501944,222
7864,3483217,3,18356294,18356398,18356346,104
7865,3483217,3,22459198,22459337,22459267,139
7866,3483217,4,11033506,11033905,11033705,399
7867,3483217,5,7462403,7462458,7462430,55
7868,3483217,5,15323236,15323248,15323242,12
7869,3483217,5,26236814,26237555,26237184,741
7870,3483218,1,1530914,1531779,1531346,865
7871,3483218,1,17374332,17374727,17374529,395
7872,3483218,1,27153526,27154064,27153795,538
7873,3483218,3,1082036,1082419,1082227,383
7874,3483218,3,10692077,10693069,10692573,992
7875,3483218,3,22173735,22173799,22173767,64
7876,3483218,4,202156,202361,202258,205
7877,3483218,4,12452152,12455269,12453710,3117
7878,3483218,5,2070386,2070573,2070479,187
7879,3483219,1,7705531,7706153,7705842,622
7880,3483219,1,19097367,19097953,19097660,586
7881,3483219,1,29807540,29807577,29807558,37
7882,3483219,2,5980235,5980636,5980435,401
7883,3483219,3,6467306,6468618,6467962,1312
7884,3483219,3,8176476,8176523,8176499,47
7885,3483219,3,20731444,20731457,20731450,13
7886,3483219,4,7681413,7681466,7681439,53
7887,3483219,5,3857049,3858445,3857747,1396
7888,3483219,5,8999455,8999561,8999508,106
7889,3483219,5,17790396,17790908,17790652,512
7890,3483219,5,26801404,26802063,26801733,659
7891,3483220,1,7672066,7672211,7672138,145
7892,3483220,2,6257810,6262410,6260110,4600
7893,3483220,2,6698188,6698949,6698568,761
7894,3483220,3,9062417,9062570,9062493,153
7895,3483220,3,16815145,16815317,16815231,172
7896,3483220,3,22601314,22601616,22601465,302
7897,3483220,4,5715192,5716167,5715679,975
7898,3483220,4,17517709,17518447,17518078,738
7899,3483221,1,16127302,16127874,16127588,572
7900,3483221,2,10294535,10294721,10294628,186
7901,3483221,2,16769814,16769932,16769873,118
7902,3483221,3,3597609,3598666,3598137,1057
7903,3483221,3,21524871,21526455,21525663,1584
7904,3483221,4,6253826,6253988,6253907,162
7905,3483221,5,14920414,14920560,14920487,146
7906,3483221,5,19043633,19043693,19043663,60
7907,3483222,2,13910296,13910792,13910544,496
7908,3483222,3,9764345,9766133,9765239,1788
7909,3483222,3,22814013,22814731,22814372,718
7910,3483222,4,7655722,7656431,7656076,709
7911,3483222,4,13837746,13837846,13837796,100
7912,3483222,5,351786,353273,352529,1487
7913,3483223,1,4064374,4065249,4064811,875
7914,3483223,1,13881275,13881301,13881288,26
7915,3483223,1,29016784,29017356,29017070,572
7916,3483223,2,352965,353866,353415,901
7917,3483223,2,18809470,18809685,18809577,215
7918,3483223,3,5453287,5453382,5453334,95
7919,3483223,4,7088547,7088946,7088746,399
7920,3483223,4,8478826,8479367,8479096,541
7921,3483224,1,15990143,15990453,15990298,310
7922,3483224,1,23027556,23027727,23027641,171
7923,3483224,2,341876,342066,341971,190
7924,3483224,2,15972266,15973354,15972810,1088
7925,3483224,3,9951172,9951956,9951564,784
7926,3483224,3,18606023,18608372,18607197,2349
7927,3483224,4,6086605,6087220,6086912,615
7928,3483224,4,7608860,7613300,7611080,4440
7929,3483224,5,14981371,14983089,14982230,1718
7930,3483225,1,16115587,16115746,16115666,159
7931,3483225,1,26570992,26571233,26571112,241
7932,3483225,1,30223138,30223656,30223397,518
7933,3483225,2,1586460,1587261,1586860,801
7934,3483225,2,18117794,18118146,18117970,352
7935,3483225,3,8945699,8945843,8945771,144
7936,3483225,3,17458611,17459864,17459237,1253
7937,3483225,4,17542042,17543778,17542910,1736
7938,3483225,5,9276763,9277680,9277221,917
7939,3483226,1,526287,535046,530666,8759
7940,3483226,1,6528543,6528557,6528550,14
7941,3483226,1,28344466,28344530,28344498,64
7942,3483226,2,6687774,6688048,6687911,274
7943,3483226,2,16507003,16507069,16507036,66
7944,3483226,3,19612563,19612597,19612580,34
7945,3483226,4,6812140,6813120,6812630,980
7946,3483226,5,7653884,7654418,7654151,534
7947,3483226,5,13750806,13751547,13751176,741
7948,3483226,5,24673112,24673580,24673346,468
7949,3483226,5,25702946,25703631,25703288,685
7950,3483227,1,17368143,17368448,17368295,305
7951,3483227,2,8560404,8560552,8560478,148
7952,3483227,3,11136812,11136918,11136865,106
7953,3483227,3,18279021,18279636,18279328,615
7954,3483227,5,4115552,4116142,4115847,590
7955,3483227,5,8292329,8292400,8292364,71
7956,3483227,5,21319413,21319426,21319419,13
7957,3483228,1,24849532,24849673,24849602,141
7958,3483228,2,16861145,16861221,16861183,76
7959,3483228,3,12365893,12365980,12365936,87
7960,3483228,4,7243582,7244318,7243950,736
7961,3483228,4,11754429,11755161,11754795,732
7962,3483228,5,6305885,6307363,6306624,1478
7963,3483228,5,13664292,13664463,13664377,171
7964,3483228,5,18717888,18718071,18717979,183
7965,3483228,5,22408967,22409406,22409186,439
7966,3483229,1,7635089,7635235,7635162,146
7967,3483229,1,18406115,18406629,18406372,514
7968,3483229,1,23692467,23692913,23692690,446
7969,3483229,2,12269665,12272151,12270908,2486
7970,3483229,2,12654404,12654425,12654414,21
7971,3483229,3,11002244,11002397,11002320,153
7972,3483229,4,16204072,16204291,16204181,219
7973,3483229,5,2378477,2378741,2378609,264
7974,3483229,5,4102763,4104308,4103535,1545
7975,3483229,5,4128216,4128613,4128414,397
7976,3483229,5,7248465,7249111,7248788,646
7977,3483230,1,1604698,1604831,1604764,133
7978,3483230,1,8910811,8911082,8910946,271
7979,3483230,1,17292338,17293150,17292744,812
7980,3483230,1,27121774,27123476,27122625,1702
7981,3483230,1,29360547,29360764,29360655,217
7982,3483230,2,167993,168737,168365,744
7983,3483230,3,3663622,3664317,3663969,695
7984,3483230,3,8592873,8593138,8593005,265
7985,3483230,3,15869794,15870394,15870094,600
7986,3483230,5,8360351,8360436,8360393,85
7987,3483230,5,8733909,8738214,8736061,4305
7988,3483230,5,15726941,15727246,15727093,305
7989,3483230,5,26492086,26492948,26492517,862
7990,3483231,1,5837376,5837428,5837402,52
7991,3483231,1,16076607,16076815,16076711,208
7992,3483231,2,11531324,11534432,11532878,3108
7993,3483231,3,6095311,6096699,6096005,1388
7994,3483231,3,15412198,15412258,15412228,60
7995,3483231,3,17949753,17949966,17949859,213
7996,3483231,4,5731037,5731499,5731268,462
7997,3483231,5,8807100,8807138,8807119,38
7998,3483231,5,18544375,18544422,18544398,47
7999,3483232,1,7858031,7859081,7858556,1050
8000,3483232,2,7719883,7720078,7719980,195
8001,3483232,2,16942430,16943298,16942864,868
8002,3483232,3,1326992,1327553,1327272,561
8003,3483232,3,7646503,7646616,7646559,113
8004,3483232,3,17536040,17536221,17536130,181
8005,3483232,4,484109,484138,484123,29
8006,3483232,4,5482236,5482852,5482544,616
8007,3483232,5,1602754,1602779,1602766,25
8008,3483232,5,10871393,10876230,10873811,4837
8009,3483232,5,15594053,15594392,15594222,339
8010,3483232,5,23269146,23269433,23269289,287
8011,3483233,1,10580385,10580542,10580463,157
8012,3483233,1,19683879,19684305,19684092,426
8013,3483233,1,26560380,26561313,26560846,933
8014,3483233,2,611833,612813,612323,980
8015,3483233,2,6275286,6276427,6275856,1141
8016,3483233,2,17866971,17867619,17867295,648
8017,3483233,3,5896179,5896710,5896444,531
8018,3483233,3,14945007,14945105,14945056,98
8019,3483233,4,1212578,1213118,1212848,540
8020,3483233,4,17868212,17868392,17868302,180
8021,3483233,5,9203778,9203798,9203788,20
8022,3483233,5,23957534,23958254,23957894,720
8023,3483234,1,17240210,17240341,17240275,131
8024,3483234,1,27092531,27093949,27093240,1418
8025,3483234,2,9242262,9246128,9244195,3866
8026,3483234,4,1513053,1513326,1513189,273
8027,3483234,4,5461071,5461419,5461245,348
8028,3483234,5,7867460,7867732,7867596,272
8029,3483234,5,13854776,13854891,13854833,115
8030,3483235,1,12734613,12734702,12734657,89
8031,3483235,3,11811711,11812031,11811871,320
8032,3483235,3,20696893,20698436,20697664,1543
8033,3483235,4,8522981,8525356,8524168,2375
8034,3483235,4,14981315,14981906,14981610,591
8035,3483236,1,2161834,2162198,2162016,364
8036,3483236,1,10440196,10440385,10440290,189
8037,3483236,2,2198462,2198998,2198730,536
8038,3483236,2,11497312,11497393,11497352,81
8039,3483236,2,14464060,14464503,14464281,443
8040,3483236,3,9415139,9415305,9415222,166
8041,3483236,4,13832117,13832324,13832220,207
8042,3483236,4,18063788,18065733,18064760,1945
8043,3483236,5,8727021,8728116,8727568,1095
8044,3483236,5,15426537,15427044,15426790,507
8045,3483237,1,11118237,11118757,11118497,520
8046,3483237,1,20536363,20536603,20536483,240
8047,3483237,3,9280696,9282025,9281360,1329
8048,3483237,3,19929401,19932950,19931175,3549
8049,3483237,3,23209024,23212132,23210578,3108
8050,3483237,4,17203217,17204054,17203635,837
8051,3483238,1,4224588,4224744,4224666,156
8052,3483238,2,496391,496401,496396,10
8053,3483238,2,11188753,11189286,11189019,533
8054,3483238,3,10170000,10170573,10170286,573
8055,3483238,4,606145,606197,606171,52
8056,3483238,4,17596429,17598529,17597479,2100
8057,3483238,5,9057499,9057827,9057663,328
8058,3483238,5,19602739,19602777,19602758,38
8059,3483239,1,452718,454146,453432,1428
8060,3483239,1,3090581,3091125,3090853,544
8061,3483239,1,12661021,12661605,12661313,584
8062,3483239,1,22080358,22081616,22080987,1258
8063,3483239,2,2234963,2235789,2235376,826
8064,3483239,2,9823668,9825549,9824608,1881
8065,3483239,3,4583041,4583741,4583391,700
8066,3483239,3,15658296,15658622,15658459,326
8067,3483239,4,8034967,8035715,8035341,748
8068,3483239,4,17736024,17736287,17736155,263
8069,3483239,5,7270746,7270755,7270750,9
8070,3483241,1,4650732,4652413,4651572,1681
8071,3483241,1,12516122,12516273,12516197,151
8072,3483241,1,27437582,27437846,27437714,264
8073,3483241,2,1140493,1140699,1140596,206
8074,3483241,2,8229935,8229936,8229935,1
8075,3483241,2,12011918,12012403,12012160,485
8076,3483241,3,8715981,8716036,8716008,55
8077,3483241,3,18457070,18460958,18459014,3888
8078,3483241,4,524754,524917,524835,163
8079,3483241,5,510302,510312,510307,10
8080,3483242,3,15411748,15412198,15411973,450
8081,3483242,4,8291466,8292065,8291765,599
8082,3483243,1,9788094,9790491,9789292,2397
8083,3483243,1,13312861,13317896,13315378,5035
8084,3483243,1,24782315,24782965,24782640,650
8085,3483243,3,2100541,2100638,2100589,97
8086,3483243,3,20731036,20731416,20731226,380
8087,3483243,5,9874307,9874653,9874480,346
8088,3483244,2,1568704,1568825,1568764,121
8089,3483244,2,7941821,7942269,7942045,448
8090,3483244,3,10947399,10947416,10947407,17
8091,3483244,3,18415752,18416015,18415883,263
8092,3483244,5,734446,734617,734531,171
8093,3483244,5,15873226,15873784,15873505,558
8094,3483245,1,1817246,1817812,1817529,566
8095,3483245,1,10544410,10544464,10544437,54
8096,3483245,3,3082555,3083455,3083005,900
8097,3483245,3,7867266,7868437,7867851,1171
8098,3483245,3,10419436,10420375,10419905,939
8099,3483245,3,22987623,22991606,22989614,3983
8100,3483245,4,15889643,15889920,15889781,277
8101,3483245,4,18188357,18188405,18188381,48
8102,3483245,5,21319036,21319070,21319053,34
8103,3483246,1,9365548,9365656,9365602,108
8104,3483246,1,22163979,22164520,22164249,541
8105,3483246,2,7948351,7948737,7948544,386
8106,3483246,3,1222149,1223250,1222699,1101
8107,3483247,2,4824333,4824512,4824422,179
8108,3483247,2,8963881,8963982,8963931,101
8109,3483247,3,18199754,18200047,18199900,293
8110,3483247,5,9627422,9628025,9627723,603
8111,3483248,1,3580306,3580437,3580371,131
8112,3483248,1,6499626,6499695,6499660,69
8113,3483248,1,13043194,13043292,13043243,98
8114,3483248,1,29518631,29519162,29518896,531
8115,3483248,2,373551,373638,373594,87
8116,3483248,2,5660689,5661176,5660932,487
8117,3483248,3,8904010,8904376,8904193,366
8118,3483248,5,310062,310449,310255,387
8119,3483248,5,8697338,8698563,8697950,1225
8120,3483248,5,17908804,17909592,17909198,788
8121,3483248,5,22870879,22870904,22870891,25
8122,3483249,1,6642102,6642175,6642138,73
8123,3483249,1,21720984,21721436,21721210,452
8124,3483249,1,27310708,27310961,27310834,253
8125,3483249,2,916824,917218,917021,394
8126,3483249,2,17482362,17483196,17482779,834
8127,3483249,3,18668323,18668979,18668651,656
8128,3483249,4,1529792,1529814,1529803,22
8129,3483249,4,9392816,9393065,9392940,249
8130,3483249,4,12452152,12455269,12453710,3117
8131,3483249,4,17187028,17187643,17187335,615
8132,3483249,5,25389,26691,26040,1302
8133,3483249,5,23233151,23235819,23234485,2668
8134,3483249,5,24772607,24773765,24773186,1158
8135,3483250,1,17477606,17477781,17477693,175
8136,3483250,3,15690284,15690306,15690295,22
8137,3483250,4,321427,322181,321804,754
8138,3483250,4,16686679,16687096,16686887,417
8139,3483250,5,4944795,4944969,4944882,174
8140,3483250,5,16155192,16155599,16155395,407
8141,3483251,3,3581855,3582344,3582099,489
8142,3483251,3,11102632,11102654,11102643,22
8143,3483251,3,16005225,16005240,16005232,15
8144,3483251,4,9924999,9925292,9925145,293
8145,3483251,5,6291770,6292363,6292066,593
8146,3483251,5,9686929,9687949,9687439,1020
8147,3483252,1,17283282,17283448,17283365,166
8148,3483252,1,28936924,28937757,28937340,833
8149,3483252,4,7712778,7714302,7713540,1524
8150,3483252,5,282955,283104,283029,149
8151,3483252,5,15759004,15759163,15759083,159
8152,3483252,5,18481679,18481753,18481716,74
8153,3483253,1,23945133,23945166,23945149,33
8154,3483253,1,29629843,29632631,29631237,2788
8155,3483253,2,2089619,2089716,2089667,97
8156,3483253,3,8722219,8722381,8722300,162
8157,3483253,3,22863912,22863969,22863940,57
8158,3483253,4,1504391,1504430,1504410,39
8159,3483253,4,5456227,5456339,5456283,112
8160,3483253,5,953895,954847,954371,952
8161,3483253,5,1900917,1900974,1900945,57
8162,3483253,5,19293383,19294041,19293712,658
8163,3483254,1,16564897,16564918,16564907,21
8164,3483254,1,28431833,28433770,28432801,1937
8165,3483254,2,1125048,1125220,1125134,172
8166,3483254,2,19260777,19261047,19260912,270
8167,3483254,3,844016,844486,844251,470
8168,3483254,3,8908211,8910864,8909537,2653
8169,3483254,3,15865616,15865802,15865709,186
8170,3483254,4,1023562,1026302,1024932,2740
8171,3483254,4,5247028,5247922,5247475,894
8172,3483254,4,17628544,17629291,17628917,747
8173,3483254,5,631557,631611,631584,54
8174,3483254,5,10461698,10461813,10461755,115
8175,3483255,1,8104249,8104447,8104348,198
8176,3483255,2,15170840,15173269,15172054,2429
8177,3483255,3,8285372,8286460,8285916,1088
8178,3483255,3,19055368,19057394,19056381,2026
8179,3483255,3,20539890,20540954,20540422,1064
8180,3483255,4,10601930,10601993,10601961,63
8181,3483255,4,12213450,12213997,12213723,547
8182,3483255,5,8567471,8569949,8568710,2478
8183,3483255,5,18556469,18557482,18556975,1013
8184,3483255,5,25498918,25499440,25499179,522
8185,3483256,1,8169011,8169258,8169134,247
8186,3483256,1,11717340,11717917,11717628,577
8187,3483256,1,29138259,29138471,29138365,212
8188,3483256,2,2089619,2089716,2089667,97
8189,3483256,2,16844643,16845013,16844828,370
8190,3483256,3,7767670,7767756,7767713,86
8191,3483256,4,6183022,6185472,6184247,2450
8192,3483256,4,12146314,12146420,12146367,106
8193,3483256,5,9956723,9956839,9956781,116
8194,3483256,5,13693414,13693626,13693520,212
8195,3483257,1,7749420,7749685,7749552,265
8196,3483257,1,19140809,19141464,19141136,655
8197,3483257,1,28932190,28932250,28932220,60
8198,3483257,2,15019428,15022480,15020954,3052
8199,3483257,2,18729386,18730322,18729854,936
8200,3483257,3,3523290,3523735,3523512,445
8201,3483257,3,16886967,16887212,16887089,245
8202,3483257,3,18594729,18595037,18594883,308
8203,3483257,5,4637501,4638161,4637831,660
8204,3483257,5,23065950,23066128,23066039,178
8205,3483258,1,16668456,16668667,16668561,211
8206,3483258,1,20103694,20104590,20104142,896
8207,3483258,2,5536222,5537099,5536660,877
8208,3483258,2,15189860,15190670,15190265,810
8209,3483258,3,8819635,8819730,8819682,95
8210,3483258,3,17620760,17620851,17620805,91
8211,3483258,3,23021864,23022006,23021935,142
8212,3483258,4,110913,111703,111308,790
8213,3483258,4,5144053,5144066,5144059,13
8214,3483258,4,15481747,15481826,15481786,79
8215,3483258,5,14535676,14536000,14535838,324
8216,3483258,5,26745331,26745410,26745370,79
8217,3483259,1,11214415,11214477,11214446,62
8218,3483259,2,7052505,7052641,7052573,136
8219,3483259,2,9566674,9566817,9566745,143
8220,3483259,3,2174734,2175032,2174883,298
8221,3483259,3,15741055,15741173,15741114,118
8222,3483260,1,8684190,8684293,8684241,103
8223,3483260,1,25287151,25287329,25287240,178
8224,3483260,2,2899114,2899783,2899448,669
8225,3483260,2,5004150,5005611,5004880,1461
8226,3483260,2,7047839,7048981,7048410,1142
8227,3483260,2,10042400,10043200,10042800,800
8228,3483260,3,10730044,10730218,10730131,174
8229,3483260,4,6205677,6206136,6205906,459
8230,3483260,5,6122580,6122692,6122636,112
8231,3483261,1,13033012,13033405,13033208,393
8232,3483261,2,373394,373638,373516,244
8233,3483261,4,7394658,7394761,7394709,103
8234,3483262,1,5118581,5119148,5118864,567
8235,3483262,1,18363120,18363328,18363224,208
8236,3483262,2,319313,319327,319320,14
8237,3483262,2,16257858,16258147,16258002,289
8238,3483262,5,4156243,4156264,4156253,21
8239,3483262,5,8807064,8807100,8807082,36
8240,3483262,5,9336692,9338490,9337591,1798
8241,3483263,1,1094184,1097383,1095783,3199
8242,3483263,1,17717630,17717717,17717673,87
8243,3483263,1,23433441,23434135,23433788,694
8244,3483263,3,15747947,15747987,15747967,40
8245,3483263,4,10138986,10139522,10139254,536
8246,3483263,5,5213604,5214183,5213893,579
8247,3483263,5,23657340,23657925,23657632,585
8248,3483264,1,5197554,5197555,5197554,1
8249,3483264,1,8519311,8519483,8519397,172
8250,3483264,1,12706590,12707772,12707181,1182
8251,3483264,1,16446459,16446563,16446511,104
8252,3483264,2,122579,123263,122921,684
8253,3483264,2,6807222,6807863,6807542,641
8254,3483264,3,15903802,15906538,15905170,2736
8255,3483264,4,6209852,6209933,6209892,81
8256,3483264,4,6487990,6488122,6488056,132
8257,3483264,5,17916574,17916610,17916592,36
8258,3483264,5,24320560,24320845,24320702,285
8259,3483265,1,18133721,18133955,18133838,234
8260,3483265,1,23509118,23509385,23509251,267
8261,3483265,2,6197361,6198433,6197897,1072
8262,3483265,3,11402264,11402284,11402274,20
8263,3483265,4,5371966,5372087,5372026,121
8264,3483265,5,7278380,7279006,7278693,626
8265,3483265,5,8733758,8733909,8733833,151
8266,3483265,5,18822446,18823192,18822819,746
8267,3483265,5,21388084,21389146,21388615,1062
8268,3483266,1,1572915,1573156,1573035,241
8269,3483266,1,7853344,7853360,7853352,16
8270,3483266,1,26371807,26372307,26372057,500
8271,3483266,2,6038047,6039006,6038526,959
8272,3483266,3,1756817,1758495,1757656,1678
8273,3483266,3,22764718,22767145,22765931,2427
8274,3483266,4,1512989,1513326,1513157,337
8275,3483266,4,6246667,6247005,6246836,338
8276,3483266,4,17757476,17758040,17757758,564
8277,3483266,5,15214102,15214304,15214203,202
8278,3483266,5,26561567,26561838,26561702,271
8279,3483267,1,4120891,4121964,4121427,1073
8280,3483267,1,17171618,17171964,17171791,346
8281,3483267,2,881972,883708,882840,1736
8282,3483267,2,2261196,2264060,2262628,2864
8283,3483267,3,11731663,11732514,11732088,851
8284,3483267,3,17211103,17211164,17211133,61
8285,3483267,3,17991320,17991593,17991456,273
8286,3483267,4,8898325,8898519,8898422,194
8287,3483267,5,26585530,26585549,26585539,19
8288,3483268,1,8140798,8141018,8140908,220
8289,3483268,1,10548715,10549398,10549056,683
8290,3483268,1,29389741,29391390,29390565,1649
8291,3483268,2,1828263,1828481,1828372,218
8292,3483268,3,10300198,10300515,10300356,317
8293,3483268,4,5277365,5277462,5277413,97
8294,3483268,4,6200459,6200471,6200465,12
8295,3483268,5,21537726,21537768,21537747,42
8296,3483269,1,12710290,12711685,12710987,1395
8297,3483269,2,8372546,8372736,8372641,190
8298,3483269,2,15582315,15584257,15583286,1942
8299,3483269,3,19978362,19978833,19978597,471
8300,3483269,4,1245087,1245235,1245161,148
8301,3483269,5,1404804,1407375,1406089,2571
8302,3483269,5,7979855,7980019,7979937,164
8303,3483269,5,18037228,18037477,18037352,249
8304,3483270,1,26409777,26410107,26409942,330
8305,3483270,2,2112678,2114785,2113731,2107
8306,3483270,2,8544843,8544873,8544858,30
8307,3483270,3,7997423,7997448,7997435,25
8308,3483270,3,18812434,18813950,18813192,1516
8309,3483270,4,17425180,17425208,17425194,28
8310,3483271,1,19437546,19437857,19437701,311
8311,3483271,1,22981725,22981965,22981845,240
8312,3483271,2,8895239,8895402,8895320,163
8313,3483271,2,14489872,14490638,14490255,766
8314,3483271,3,10589382,10589753,10589567,371
8315,3483271,4,6859153,6859331,6859242,178
8316,3483271,4,7274691,7274777,7274734,86
8317,3483271,5,2194008,2194278,2194143,270
8318,3483271,5,15018544,15018960,15018752,416
8319,3483271,5,20271736,20272508,20272122,772
8320,3483272,1,6243815,6243927,6243871,112
8321,3483272,1,16460927,16462258,16461592,1331
8322,3483272,1,26605648,26608233,26606940,2585
8323,3483272,2,2089817,2089837,2089827,20
8324,3483272,2,7740664,7740949,7740806,285
8325,3483272,2,15541693,15541801,15541747,108
8326,3483272,2,18461335,18461620,18461477,285
8327,3483272,3,531906,531982,531944,76
8328,3483272,3,10223699,10224058,10223878,359
8329,3483272,3,18001393,18001628,18001510,235
8330,3483272,4,12448855,12449164,12449009,309
8331,3483272,5,195296,195385,195340,89
8332,3483272,5,18892123,18892284,18892203,161
8333,3483272,5,26852891,26853204,26853047,313
8334,3483274,1,11279143,11279672,11279407,529
8335,3483274,2,527387,527966,527676,579
8336,3483274,3,22738592,22740079,22739335,1487
8337,3483274,4,5239987,5240515,5240251,528
8338,3483274,4,9343863,9344253,9344058,390
8339,3483274,5,9043938,9044516,9044227,578
8340,3483274,5,21728885,21729791,21729338,906
8341,3483275,1,3578910,3580185,3579547,1275
8342,3483275,1,26416518,26417944,26417231,1426
8343,3483275,4,6558067,6558468,6558267,401
8344,3483275,4,17594667,17594742,17594704,75
8345,3483275,5,21141760,21141872,21141816,112
8346,3483276,1,18108435,18108490,18108462,55
8347,3483276,2,1599036,1599097,1599066,61
8348,3483276,2,7834783,7835027,7834905,244
8349,3483276,3,18463157,18464572,18463864,1415
8350,3483276,4,7825328,7825901,7825614,573
8351,3483276,4,10160171,10160407,10160289,236
8352,3483277,1,5723369,5724627,5723998,1258
8353,3483277,2,488552,489485,489018,933
8354,3483277,2,2100749,2100773,2100761,24
8355,3483277,3,12773579,12773779,12773679,200
8356,3483277,4,5135682,5135783,5135732,101
8357,3483277,4,6257262,6257385,6257323,123
8358,3483277,4,17677680,17678216,17677948,536
8359,3483277,5,1590891,1591791,1591341,900
8360,3483277,5,13752287,13752856,13752571,569
8361,3483277,5,25601618,25603565,25602591,1947
8362,3483278,1,4214222,4214251,4214236,29
8363,3483278,1,17588819,17588825,17588822,6
8364,3483278,2,11731312,11732032,11731672,720
8365,3483278,2,16240928,16241065,16240996,137
8366,3483278,3,4881431,4883280,4882355,1849
8367,3483278,3,9719306,9719521,9719413,215
8368,3483278,3,18080722,18081104,18080913,382
8369,3483278,5,245966,246425,246195,459
8370,3483278,5,16744376,16744481,16744428,105
8371,3483278,5,23272394,23273194,23272794,800
8372,3483279,2,614330,614605,614467,275
8373,3483279,3,9883795,9884561,9884178,766
8374,3483279,3,20429130,20429255,20429192,125
8375,3483279,5,245573,245966,245769,393
8376,3483279,5,14035782,14040108,14037945,4326
8377,3483279,5,25245631,25247079,25246355,1448
8378,3483280,1,26047142,26047221,26047181,79
8379,3483280,2,10552059,10552565,10552312,506
8380,3483280,3,661593,662927,662260,1334
8381,3483280,3,18183363,18183640,18183501,277
8382,3483280,5,4127510,4128613,4128061,1103
8383,3483281,1,1183077,1184093,1183585,1016
8384,3483281,1,3155619,3155805,3155712,186
8385,3483281,1,6871182,6871474,6871328,292
8386,3483281,1,12523478,12524083,12523780,605
8387,3483281,1,27143228,27143884,27143556,656
8388,3483281,1,28415776,28416013,28415894,237
8389,3483281,1,28846437,28847035,28846736,598
8390,3483281,1,30366404,30367779,30367091,1375
8391,3483281,2,8014756,8014866,8014811,110
8392,3483281,2,8613853,8615989,8614921,2136
8393,3483281,2,9680909,9684442,9682675,3533
8394,3483281,3,2717029,2717104,2717066,75
8395,3483281,3,3145437,3145534,3145485,97
8396,3483281,5,2691354,2691643,2691498,289
8397,3483281,5,3193510,3193889,3193699,379
8398,3483281,5,4116236,4116644,4116440,408
8399,3483281,5,14519729,14520944,14520336,1215
8400,3483281,5,16812498,16812930,16812714,432
8401,3483281,5,20669483,20669816,20669649,333
8402,3483282,2,6653526,6653692,6653609,166
8403,3483282,2,12913180,12913484,12913332,304
8404,3483283,1,3641909,3641927,3641918,18
8405,3483283,2,2928694,2928762,2928728,68
8406,3483283,3,9408202,9408285,9408243,83
8407,3483283,4,9030729,9031710,9031219,981
8408,3483283,5,13700003,13700048,13700025,45
8409,3483283,5,26938106,26938388,26938247,282
8410,3483284,1,4211085,4211407,4211246,322
8411,3483284,1,17590731,17590871,17590801,140
8412,3483284,2,11728711,11729352,11729031,641
8413,3483284,2,16240928,16241065,16240996,137
8414,3483284,3,4872912,4873876,4873394,964
8415,3483284,3,9713634,9713869,9713751,235
8416,3483284,3,18064221,18065541,18064881,1320
8417,3483284,5,232383,232926,232654,543
8418,3483284,5,16763434,16763630,16763532,196
8419,3483284,5,23176875,23178084,23177479,1209
8420,3483285,1,2754795,2759388,2757091,4593
8421,3483285,1,25073560,25075181,25074370,1621
8422,3483285,2,12686957,12686979,12686968,22
8423,3483285,3,4462001,4462207,4462104,206
8424,3483285,3,10503857,10503892,10503874,35
8425,3483285,4,14120740,14121466,14121103,726
8426,3483285,5,3532073,3532144,3532108,71
8427,3483285,5,10823547,10828010,10825778,4463
8428,3483285,5,17425740,17426119,17425929,379
8429,3483285,5,18464332,18465015,18464673,683
8430,3483285,5,22081394,22081401,22081397,7
8431,3483285,5,24770981,24771059,24771020,78
8432,3483286,1,13064973,13065848,13065410,875
8433,3483286,2,7031484,7033666,7032575,2182
8434,3483286,2,19261047,19261210,19261128,163
8435,3483286,3,3398537,3399213,3398875,676
8436,3483286,3,7776857,7778512,7777684,1655
8437,3483286,5,14538886,14538899,14538892,13
8438,3483286,5,20713130,20713405,20713267,275
8439,3483287,1,26376660,26376744,26376702,84
8440,3483287,1,30036735,30037148,30036941,413
8441,3483287,3,8607879,8608212,8608045,333
8442,3483287,3,15957182,15957222,15957202,40
8443,3483287,4,652041,652273,652157,232
8444,3483287,4,11985607,11987179,11986393,1572
8445,3483287,5,7847023,7847201,7847112,178
8446,3483287,5,19148682,19149835,19149258,1153
8447,3483288,1,1784840,1785557,1785198,717
8448,3483288,1,16453432,16453637,16453534,205
8449,3483288,2,7736134,7736523,7736328,389
8450,3483288,2,9534483,9534558,9534520,75
8451,3483288,3,10778400,10778522,10778461,122
8452,3483288,4,149863,151540,150701,1677
8453,3483288,4,14741931,14742111,14742021,180
8454,3483288,4,17733478,17734891,17734184,1413
8455,3483288,5,13935679,13937932,13936805,2253
8456,3483288,5,16081132,16081340,16081236,208
8457,3483289,1,8344436,8344563,8344499,127
8458,3483289,1,23903908,23904144,23904026,236
8459,3483289,2,1599294,1599514,1599404,220
8460,3483289,2,10820397,10820458,10820427,61
8461,3483289,3,826856,827587,827221,731
8462,3483289,5,2571017,2571724,2571370,707
8463,3483289,5,8801209,8801434,8801321,225
8464,3483289,5,26678597,26679332,26678964,735
8465,3483290,1,17238362,17240210,17239286,1848
8466,3483290,1,20020022,20020311,20020166,289
8467,3483290,2,18729386,18729819,18729602,433
8468,3483290,3,12100791,12100806,12100798,15
8469,3483290,3,18275658,18276352,18276005,694
8470,3483290,5,311734,312294,312014,560
8471,3483290,5,14995487,14995902,14995694,415
8472,3483291,1,2423758,2424814,2424286,1056
8473,3483291,1,13276190,13276532,13276361,342
8474,3483291,1,24223963,24224115,24224039,152
8475,3483291,3,822575,822685,822630,110
8476,3483291,3,16560938,16563825,16562381,2887
8477,3483291,5,5009099,5009282,5009190,183
8478,3483291,5,18518318,18524719,18521518,6401
8479,3483292,1,6530107,6530128,6530117,21
8480,3483292,2,10104746,10105258,10105002,512
8481,3483292,3,641153,641304,641228,151
8482,3483292,3,9501833,9502055,9501944,222
8483,3483292,3,10738127,10738583,10738355,456
8484,3483292,3,19705126,19706843,19705984,1717
8485,3483292,4,1191987,1192086,1192036,99
8486,3483292,5,21788525,21788894,21788709,369
8487,3483293,1,6675599,6675933,6675766,334
8488,3483293,1,16643196,16644086,16643641,890
8489,3483293,1,17655275,17656246,17655760,971
8490,3483293,1,29487930,29487955,29487942,25
8491,3483293,2,6196539,6196698,6196618,159
8492,3483293,4,6923089,6923170,6923129,81
8493,3483293,5,20494435,20494607,20494521,172
8494,3483294,1,18555273,18555794,18555533,521
8495,3483294,2,812200,812905,812552,705
8496,3483294,2,1554369,1554519,1554444,150
8497,3483294,3,7835003,7836698,7835850,1695
8498,3483294,3,14996294,14996371,14996332,77
8499,3483294,4,325483,325641,325562,158
8500,3483294,4,484180,484468,484324,288
8501,3483294,4,14863304,14864972,14864138,1668
8502,3483294,4,17009560,17011275,17010417,1715
8503,3483294,5,7311274,7311759,7311516,485
8504,3483294,5,17357950,17360641,17359295,2691
8505,3483295,1,9173001,9173122,9173061,121
8506,3483295,2,6921002,6921187,6921094,185
8507,3483295,3,4449043,4452589,4450816,3546
8508,3483295,3,5445278,5446678,5445978,1400
8509,3483295,3,23045990,23046185,23046087,195
8510,3483295,4,529864,530419,530141,555
8511,3483295,4,6840333,6841201,6840767,868
8512,3483295,5,7226874,7230351,7228612,3477
8513,3483295,5,9917422,9917900,9917661,478
8514,3483295,5,24117067,24117529,24117298,462
8515,3483296,1,473429,474735,474082,1306
8516,3483296,1,1139600,1139955,1139777,355
8517,3483296,1,2883006,2884312,2883659,1306
8518,3483296,1,9364128,9365022,9364575,894
8519,3483296,1,10107236,10107330,10107283,94
8520,3483296,1,13118964,13122770,13120867,3806
8521,3483296,1,26890325,26890342,26890333,17
8522,3483296,2,10687773,10687861,10687817,88
8523,3483296,3,9745718,9745733,9745725,15
8524,3483296,3,9847527,9847879,9847703,352
8525,3483296,3,11916017,11916164,11916090,147
8526,3483296,3,12444975,12445013,12444994,38
8527,3483296,3,19733756,19734184,19733970,428
8528,3483296,3,20253992,20254085,20254038,93
8529,3483296,4,5445598,5445639,5445618,41
8530,3483296,4,6737427,6737493,6737460,66
8531,3483296,4,10050588,10050928,10050758,340
8532,3483296,4,14730872,14731021,14730946,149
8533,3483296,5,7052943,7053030,7052986,87
8534,3483296,5,9913960,9914013,9913986,53
8535,3483296,5,10923446,10923491,10923468,45
8536,3483296,5,23368022,23368612,23368317,590
8537,3483297,1,1741545,1741801,1741673,256
8538,3483297,2,6788566,6788673,6788619,107
8539,3483297,2,12098873,12104379,12101626,5506
8540,3483297,4,6444538,6445614,6445076,1076
8541,3483297,5,9084306,9084431,9084368,125
8542,3483297,5,26680097,26680762,26680429,665
8543,3483298,1,16269635,16272591,16271113,2956
8544,3483298,1,26755252,26756530,26755891,1278
8545,3483298,2,8250731,8250768,8250749,37
8546,3483298,2,11740302,11740407,11740354,105
8547,3483298,3,7905821,7907367,7906594,1546
8548,3483298,3,17320784,17321207,17320995,423
8549,3483298,4,5168353,5168555,5168454,202
8550,3483298,4,16853906,16854360,16854133,454
8551,3483299,2,15114250,15114500,15114375,250
8552,3483299,3,7353751,7354031,7353891,280
8553,3483299,3,11139866,11140395,11140130,529
8554,3483299,4,6584881,6584890,6584885,9
8555,3483299,5,7179507,7179691,7179599,184
8556,3483300,1,11000486,11000513,11000499,27
8557,3483300,1,13049585,13050241,13049913,656
8558,3483300,2,1032210,1032698,1032454,488
8559,3483300,3,2961943,2962555,2962249,612
8560,3483300,4,5363572,5364975,5364273,1403
8561,3483300,4,15844096,15846160,15845128,2064
8562,3483300,5,6618597,6618946,6618771,349
8563,3483300,5,18380239,18381631,18380935,1392
8564,3483300,5,25066686,25066954,25066820,268
8565,3483301,1,9139744,9140919,9140331,1175
8566,3483301,1,12974032,12974439,12974235,407
8567,3483301,2,10218812,10219901,10219356,1089
8568,3483301,2,15554784,15555048,15554916,264
8569,3483301,4,6148438,6148942,6148690,504
8570,3483301,4,10837366,10837369,10837367,3
8571,3483301,5,699910,699919,699914,9
8572,3483301,5,15381963,15382749,15382356,786
8573,3483301,5,16156212,16156320,16156266,108
8574,3483302,1,22590865,22591017,22590941,152
8575,3483302,3,16023517,16023590,16023553,73
8576,3483302,4,5168353,5168555,5168454,202
8577,3483302,5,14878310,14878366,14878338,56
8578,3483303,1,9447325,9447358,9447341,33
8579,3483303,4,1031019,1031358,1031188,339
8580,3483303,4,8500395,8502609,8501502,2214
8581,3483303,5,9313699,9313837,9313768,138
8582,3483303,5,26424989,26426536,26425762,1547
8583,3483304,2,201328,201690,201509,362
8584,3483304,2,10545011,10545264,10545137,253
8585,3483304,2,13512602,13512709,13512655,107
8586,3483304,3,8245126,8245247,8245186,121
8587,3483304,5,811481,812336,811908,855
8588,3483304,5,15788389,15788747,15788568,358
8589,3483304,5,23086332,23090857,23088594,4525
8590,3483305,1,7915582,7916602,7916092,1020
8591,3483305,3,10995340,10995448,10995394,108
8592,3483305,4,10972435,10973055,10972745,620
8593,3483305,5,10280290,10281139,10280714,849
8594,3483305,5,15381299,15382749,15382024,1450
8595,3483306,1,1863797,1864171,1863984,374
8596,3483306,1,17231451,17232058,17231754,607
8597,3483306,3,19167860,19168032,19167946,172
8598,3483306,4,5661430,5661676,5661553,246
8599,3483306,4,6107366,6107667,6107516,301
8600,3483306,5,384053,384609,384331,556
8601,3483306,5,14707494,14708515,14708004,1021
8602,3483307,1,4452941,4453501,4453221,560
8603,3483307,1,17599064,17599405,17599234,341
8604,3483307,1,24886006,24886587,24886296,581
8605,3483307,1,27666540,27666590,27666565,50
8606,3483307,2,5800585,5800984,5800784,399
8607,3483307,2,12175217,12175961,12175589,744
8608,3483307,3,7221629,7222337,7221983,708
8609,3483307,3,11105605,11105718,11105661,113
8610,3483307,3,21512853,21513104,21512978,251
8611,3483307,4,18018834,18019137,18018985,303
8612,3483307,5,14959720,14959859,14959789,139
8613,3483307,5,15866340,15866460,15866400,120
8614,3483307,5,17992073,17993201,17992637,1128
8615,3483307,5,26189284,26189344,26189314,60
8616,3483308,5,4840022,4842867,4841444,2845
8617,3483308,5,17995400,17995511,17995455,111
8618,3483309,1,3637855,3637935,3637895,80
8619,3483309,1,17581748,17581933,17581840,185
8620,3483309,1,22975777,22976430,22976103,653
8621,3483309,2,1640678,1640902,1640790,224
8622,3483309,2,5324269,5324331,5324300,62
8623,3483309,2,9582009,9582496,9582252,487
8624,3483309,3,6150792,6150990,6150891,198
8625,3483309,4,1933623,1933833,1933728,210
8626,3483309,4,5562910,5563336,5563123,426
8627,3483309,4,8608233,8608354,8608293,121
8628,3483309,4,12036763,12036893,12036828,130
8629,3483309,5,10560895,10561439,10561167,544
8630,3483309,5,22829391,22833844,22831617,4453
8631,3483310,1,13568676,13568787,13568731,111
8632,3483310,3,22054721,22055279,22055000,558
8633,3483310,4,5712609,5713442,5713025,833
8634,3483310,5,17198212,17198667,17198439,455
8635,3483311,1,6410655,6412071,6411363,1416
8636,3483311,1,11795160,11795366,11795263,206
8637,3483311,1,13148133,13148609,13148371,476
8638,3483311,3,8183436,8184947,8184191,1511
8639,3483312,1,4578628,4578957,4578792,329
8640,3483312,1,28247492,28247505,28247498,13
8641,3483312,2,7272385,7274728,7273556,2343
8642,3483312,2,9978678,9980582,9979630,1904
8643,3483312,2,17730796,17730825,17730810,29
8644,3483312,3,2140740,2141646,2141193,906
8645,3483312,3,10631455,10631587,10631521,132
8646,3483312,3,22874638,22875058,22874848,420
8647,3483312,5,1484759,1485632,1485195,873
8648,3483312,5,25430583,25430738,25430660,155
8649,3483313,2,16951877,16952398,16952137,521
8650,3483313,2,19434933,19435811,19435372,878
8651,3483313,3,15969566,15971671,15970618,2105
8652,3483314,1,13369905,13369915,13369910,10
8653,3483314,1,18019361,18019497,18019429,136
8654,3483314,1,29677488,29679916,29678702,2428
8655,3483314,2,6196204,6196377,6196290,173
8656,3483314,3,942088,943400,942744,1312
8657,3483314,3,10142008,10142713,10142360,705
8658,3483314,3,16789846,16790537,16790191,691
8659,3483314,4,7807771,7808014,7807892,243
8660,3483314,5,9219404,9219455,9219429,51
8661,3483315,1,1173298,1173413,1173355,115
8662,3483315,1,11353249,11353430,11353339,181
8663,3483315,1,25457875,25457906,25457890,31
8664,3483315,2,973847,974708,974277,861
8665,3483315,2,1491084,1491614,1491349,530
8666,3483315,2,18333854,18334353,18334103,499
8667,3483315,3,572475,574957,573716,2482
8668,3483315,4,5150095,5150380,5150237,285
8669,3483315,4,10161036,10161110,10161073,74
8670,3483315,4,17015549,17016288,17015918,739
8671,3483315,5,9420361,9420854,9420607,493
8672,3483315,5,15903095,15903902,15903498,807
8673,3483315,5,22580168,22580547,22580357,379
8674,3483316,1,1816413,1817812,1817112,1399
8675,3483316,1,18437300,18438933,18438116,1633
8676,3483316,2,2292398,2292473,2292435,75
8677,3483316,2,2927023,2927043,2927033,20
8678,3483316,3,15894889,15895140,15895014,251
8679,3483316,4,1028677,1028832,1028754,155
8680,3483316,4,6032161,6032223,6032192,62
8681,3483316,5,3188886,3189056,3188971,170
8682,3483316,5,9056935,9057827,9057381,892
8683,3483317,1,3831120,3832261,3831690,1141
8684,3483317,1,20098742,20098864,20098803,122
8685,3483317,1,22422040,22422855,22422447,815
8686,3483317,1,23701793,23703918,23702855,2125
8687,3483317,2,7050545,7050941,7050743,396
8688,3483317,3,8930056,8930592,8930324,536
8689,3483317,4,6769805,6769820,6769812,15
8690,3483317,5,4607891,4608310,4608100,419
8691,3483317,5,23782324,23782332,23782328,8
8692,3483318,1,5818363,5820915,5819639,2552
8693,3483318,1,13144768,13145626,13145197,858
8694,3483318,2,8574489,8576110,8575299,1621
8695,3483318,2,8576110,8576294,8576202,184
8696,3483318,2,14914421,14914593,14914507,172
8697,3483318,3,19574218,19574671,19574444,453
8698,3483318,5,9686125,9687949,9687037,1824
8699,3483318,5,14820209,14821868,14821038,1659
8700,3483319,1,440381,445271,442826,4890
8701,3483319,1,12216896,12217364,12217130,468
8702,3483319,1,19881245,19881509,19881377,264
8703,3483319,1,28542663,28543112,28542887,449
8704,3483319,2,7415018,7415077,7415047,59
8705,3483319,2,11591256,11591465,11591360,209
8706,3483319,3,130294,131024,130659,730
8707,3483319,3,5792552,5793948,5793250,1396
8708,3483319,3,16468588,16468699,16468643,111
8709,3483319,4,12083065,12083165,12083115,100
8710,3483320,1,16404293,16404316,16404304,23
8711,3483320,2,8091049,8091099,8091074,50
8712,3483320,2,16757354,16757784,16757569,430
8713,3483320,3,1453164,1453279,1453221,115
8714,3483320,4,7337315,7337476,7337395,161
8715,3483320,5,25978356,25978794,25978575,438
8716,3483321,3,9771562,9771988,9771775,426
8717,3483321,3,20252643,20252674,20252658,31
8718,3483322,1,1421844,1423007,1422425,1163
8719,3483322,1,26249846,26249944,26249895,98
8720,3483322,1,29191660,29193419,29192539,1759
8721,3483322,2,82984,83174,83079,190
8722,3483322,3,251659,253037,252348,1378
8723,3483322,4,10477703,10477849,10477776,146
8724,3483322,5,533707,533715,533711,8
8725,3483322,5,14119820,14119895,14119857,75
8726,3483322,5,15607517,15607897,15607707,380
8727,3483323,1,2584749,2585038,2584893,289
8728,3483323,1,12210983,12211801,12211392,818
8729,3483323,1,16739022,16739496,16739259,474
8730,3483323,2,12913180,12913484,12913332,304
8731,3483323,3,19007032,19007205,19007118,173
8732,3483323,4,5436471,5437081,5436776,610
8733,3483323,4,15489574,15489628,15489601,54
8734,3483323,5,3489063,3490063,3489563,1000
8735,3483323,5,9947956,9948279,9948117,323
8736,3483324,4,2039750,2044206,2041978,4456
8737,3483324,5,20991723,20992534,20992128,811
8738,3483324,5,21839577,21839666,21839621,89
8739,3483325,1,179175,179753,179464,578
8740,3483325,1,11861380,11861430,11861405,50
8741,3483325,2,293914,295317,294615,1403
8742,3483325,2,12931927,12932451,12932189,524
8743,3483325,3,7611582,7612478,7612030,896
8744,3483325,4,605948,606145,606046,197
8745,3483325,4,14621239,14621248,14621243,9
8746,3483325,5,7306811,7309901,7308356,3090
8747,3483325,5,17734583,17734591,17734587,8
8748,3483326,1,19557202,19557583,19557392,381
8749,3483326,2,4810010,4810087,4810048,77
8750,3483326,3,9837876,9838140,9838008,264
8751,3483326,3,10726439,10726742,10726590,303
8752,3483326,4,7314377,7317154,7315765,2777
8753,3483326,4,9930371,9930560,9930465,189
8754,3483327,1,5638876,5640774,5639825,1898
8755,3483327,1,10935094,10938134,10936614,3040
8756,3483327,1,21866266,21867739,21867002,1473
8757,3483327,1,23276974,23277645,23277309,671
8758,3483327,3,4344146,4346182,4345164,2036
8759,3483327,3,10300862,10301599,10301230,737
8760,3483327,3,19059670,19064978,19062324,5308
8761,3483327,4,11839313,11839567,11839440,254
8762,3483327,5,1148035,1148132,1148083,97
8763,3483327,5,7900681,7900779,7900730,98
8764,3483327,5,16479025,16479067,16479046,42
8765,3483328,1,6017009,6020668,6018838,3659
8766,3483328,1,21906360,21906589,21906474,229
8767,3483328,3,10051572,10054594,10053083,3022
8768,3483328,3,17791091,17791401,17791246,310
8769,3483328,5,21749099,21749152,21749125,53
8770,3483329,1,1570222,1571671,1570946,1449
8771,3483329,1,11684666,11686168,11685417,1502
8772,3483329,1,13457096,13457948,13457522,852
8773,3483329,1,23102845,23104742,23103793,1897
8774,3483329,1,24661784,24661892,24661838,108
8775,3483329,3,8979824,8980123,8979973,299
8776,3483329,3,17133482,17133521,17133501,39
8777,3483329,5,7348876,7350424,7349650,1548
8778,3483330,1,29386638,29387658,29387148,1020
8779,3483330,4,9959901,9964884,9962392,4983
8780,3483330,5,9007529,9007832,9007680,303
8781,3483330,5,14621211,14623601,14622406,2390
8782,3483331,1,25650486,25650497,25650491,11
8783,3483331,2,7880484,7881001,7880742,517
8784,3483331,2,13944533,13944769,13944651,236
8785,3483331,2,17253894,17260830,17257362,6936
8786,3483331,3,18570197,18570667,18570432,470
8787,3483331,4,13674666,13677531,13676098,2865
8788,3483331,5,925906,926644,926275,738
8789,3483331,5,15564513,15565865,15565189,1352
8790,3483332,1,4831953,4835546,4833749,3593
8791,3483332,1,11125961,11126734,11126347,773
8792,3483332,1,29534745,29534832,29534788,87
8793,3483332,2,6740850,6741379,6741114,529
8794,3483332,2,16296326,16296874,16296600,548
8795,3483332,3,195332,195879,195605,547
8796,3483332,3,3663622,3664317,3663969,695
8797,3483332,4,5645727,5646362,5646044,635
8798,3483332,4,17315961,17316135,17316048,174
8799,3483332,5,14245098,14245728,14245413,630
8800,3483333,1,4050066,4050076,4050071,10
8801,3483333,1,10677520,10678349,10677934,829
8802,3483333,1,17778338,17778450,17778394,112
8803,3483333,2,7714768,7714813,7714790,45
8804,3483333,3,887844,888042,887943,198
8805,3483333,3,15562600,15562644,15562622,44
8806,3483333,4,7794854,7794890,7794872,36
8807,3483333,4,16457772,16457880,16457826,108
8808,3483333,5,16245783,16245844,16245813,61
8809,3483333,5,24768129,24768883,24768506,754
8810,3483334,1,29201454,29201730,29201592,276
8811,3483334,2,14630083,14631148,14630615,1065
8812,3483334,3,10144919,10144958,10144938,39
8813,3483334,3,18014838,18015800,18015319,962
8814,3483334,4,644999,645215,645107,216
8815,3483334,4,7719761,7720751,7720256,990
8816,3483334,5,7888157,7888511,7888334,354
8817,3483334,5,24967471,24967524,24967497,53
8818,3483335,1,16728297,16728358,16728327,61
8819,3483335,1,28276473,28277615,28277044,1142
8820,3483335,2,508123,510092,509107,1969
8821,3483335,2,10627969,10628500,10628234,531
8822,3483335,2,17668943,17670673,17669808,1730
8823,3483335,3,10371188,10371429,10371308,241
8824,3483335,4,5244308,5245035,5244671,727
8825,3483335,4,17436311,17437201,17436756,890
8826,3483335,5,16464926,16465079,16465002,153
8827,3483336,1,8671261,8671410,8671335,149
8828,3483336,1,24055834,24055924,24055879,90
8829,3483336,4,7130778,7131709,7131243,931
8830,3483336,4,7587165,7590074,7588619,2909
8831,3483336,5,8554263,8554478,8554370,215
8832,3483336,5,16545642,16545748,16545695,106
8833,3483336,5,21874385,21875165,21874775,780
8834,3483337,1,7748580,7749026,7748803,446
8835,3483337,1,28370649,28371780,28371214,1131
8836,3483337,2,6843439,6843557,6843498,118
8837,3483337,2,11977791,11979193,11978492,1402
8838,3483337,2,18393487,18393708,18393597,221
8839,3483337,3,8124056,8124133,8124094,77
8840,3483337,4,13046135,13046178,13046156,43
8841,3483337,5,7287773,7291802,7289787,4029
8842,3483337,5,18225784,18225790,18225787,6
8843,3483338,1,16492639,16492781,16492710,142
8844,3483338,2,6788519,6788565,6788542,46
8845,3483338,3,17093428,17094192,17093810,764
8846,3483338,4,596703,596739,596721,36
8847,3483338,4,9765962,9766971,9766466,1009
8848,3483338,4,12296471,12297235,12296853,764
8849,3483338,5,882779,884092,883435,1313
8850,3483338,5,17312491,17312791,17312641,300
8851,3483339,2,989514,989614,989564,100
8852,3483339,3,9983584,9983700,9983642,116
8853,3483339,3,22872560,22873713,22873136,1153
8854,3483339,4,1056617,1056984,1056800,367
8855,3483339,5,790272,790613,790442,341
8856,3483339,5,9054936,9056453,9055694,1517
8857,3483339,5,10229924,10231429,10230676,1505
8858,3483339,5,20482049,20482786,20482417,737
8859,3483340,1,12488202,12488470,12488336,268
8860,3483340,1,23034316,23036941,23035628,2625
8861,3483340,4,316331,316490,316410,159
8862,3483340,4,10601885,10601930,10601907,45
8863,3483340,5,10370506,10379552,10375029,9046
8864,3483341,1,19639478,19639527,19639502,49
8865,3483341,2,12236457,12237680,12237068,1223
8866,3483341,3,2135098,2139551,2137324,4453
8867,3483341,4,188702,189437,189069,735
8868,3483341,4,7312909,7314377,7313643,1468
8869,3483341,4,16811817,16812088,16811952,271
8870,3483341,5,18909491,18910497,18909994,1006
8871,3483342,1,7010212,7010325,7010268,113
8872,3483342,1,26157968,26159616,26158792,1648
8873,3483342,2,15325300,15325514,15325407,214
8874,3483342,3,11578194,11579066,11578630,872
8875,3483342,3,16907163,16907541,16907352,378
8876,3483342,4,17315961,17316135,17316048,174
8877,3483342,5,9248917,9249003,9248960,86
8878,3483342,5,9477170,9477275,9477222,105
8879,3483342,5,26601470,26602464,26601967,994
8880,3483343,1,4249323,4249346,4249334,23
8881,3483343,1,11461535,11461554,11461544,19
8882,3483343,2,865984,866223,866103,239
8883,3483343,3,11760100,11760131,11760115,31
8884,3483343,3,23310837,23311035,23310936,198
8885,3483343,4,188702,189101,188901,399
8886,3483343,4,17817833,17818243,17818038,410
8887,3483343,5,6284078,6284980,6284529,902
8888,3483343,5,9816871,9816997,9816934,126
8889,3483343,5,26559174,26559432,26559303,258
8890,3483344,1,24977083,24977144,24977113,61
8891,3483344,1,30134154,30134740,30134447,586
8892,3483344,2,12386340,12386641,12386490,301
8893,3483344,3,7161788,7162167,7161977,379
8894,3483344,4,7083207,7083400,7083303,193
8895,3483344,5,18533470,18533922,18533696,452
8896,3483344,5,25915421,25915531,25915476,110
8897,3483345,2,15975546,15975836,15975691,290
8898,3483345,3,10145379,10145418,10145398,39
8899,3483345,3,14944502,14944531,14944516,29
8900,3483345,4,5645363,5646362,5645862,999
8901,3483345,5,8687651,8690240,8688945,2589
8902,3483345,5,17203902,17203928,17203915,26
8903,3483345,5,19908195,19910208,19909201,2013
8904,3483346,1,5641382,5641450,5641416,68
8905,3483346,1,26803191,26803542,26803366,351
8906,3483346,2,360228,360576,360402,348
8907,3483346,2,5833770,5833980,5833875,210
8908,3483346,2,10725888,10728749,10727318,2861
8909,3483346,2,12445445,12445521,12445483,76
8910,3483346,3,8170948,8174634,8172791,3686
8911,3483346,3,8553439,8553570,8553504,131
8912,3483346,3,19933605,19934984,19934294,1379
8913,3483346,5,57005,57108,57056,103
8914,3483346,5,5718060,5718600,5718330,540
8915,3483346,5,8363935,8363976,8363955,41
8916,3483347,1,16674520,16674688,16674604,168
8917,3483347,1,29406877,29407472,29407174,595
8918,3483347,2,1025699,1026928,1026313,1229
8919,3483347,2,2323274,2323530,2323402,256
8920,3483347,2,13581215,13581448,13581331,233
8921,3483347,3,843331,843687,843509,356
8922,3483347,3,6145503,6145916,6145709,413
8923,3483347,4,721660,721726,721693,66
8924,3483347,4,11765318,11765744,11765531,426
8925,3483347,5,2193676,2193836,2193756,160
8926,3483347,5,16209693,16212223,16210958,2530
8927,3483347,5,24058059,24058151,24058105,92
8928,3483348,1,5667662,5667755,5667708,93
8929,3483348,1,12912283,12912322,12912302,39
8930,3483348,3,9912673,9912689,9912681,16
8931,3483348,3,17351715,17351867,17351791,152
8932,3483348,4,814856,815913,815384,1057
8933,3483348,4,10055146,10057426,10056286,2280
8934,3483348,4,10608882,10608954,10608918,72
8935,3483348,5,5716757,5717017,5716887,260
8936,3483348,5,18720602,18720605,18720603,3
8937,3483349,1,8134358,8134503,8134430,145
8938,3483349,1,10200716,10201406,10201061,690
8939,3483349,1,22865007,22865309,22865158,302
8940,3483349,1,30379034,30379236,30379135,202
8941,3483349,2,991364,992644,992004,1280
8942,3483349,2,12333927,12334012,12333969,85
8943,3483349,3,9761973,9762636,9762304,663
8944,3483349,3,19469908,19470593,19470250,685
8945,3483349,4,14618004,14619382,14618693,1378
8946,3483349,5,94324,95822,95073,1498
8947,3483349,5,6446928,6447067,6446997,139
8948,3483349,5,19303739,19304001,19303870,262
8949,3483350,1,25124583,25124669,25124626,86
8950,3483350,2,6654362,6654522,6654442,160
8951,3483350,3,10122466,10126944,10124705,4478
8952,3483350,5,8605827,8605854,8605840,27
8953,3483351,1,1786206,1788691,1787448,2485
8954,3483351,1,2664489,2665295,2664892,806
8955,3483351,1,24265291,24265301,24265296,10
8956,3483351,1,24647289,24647523,24647406,234
8957,3483351,2,9404508,9405329,9404918,821
8958,3483351,2,18804725,18804961,18804843,236
8959,3483351,3,8523583,8524110,8523846,527
8960,3483351,3,16803175,16803397,16803286,222
8961,3483351,4,7369626,7370740,7370183,1114
8962,3483351,4,16182363,16184124,16183243,1761
8963,3483351,5,706880,707681,707280,801
8964,3483351,5,14528251,14528402,14528326,151
8965,3483351,5,25641662,25642299,25641980,637
8966,3483352,1,10077688,10078713,10078200,1025
8967,3483352,1,22382844,22383015,22382929,171
8968,3483352,2,7245403,7245625,7245514,222
8969,3483352,2,12439654,12441478,12440566,1824
8970,3483352,3,8226372,8226572,8226472,200
8971,3483352,3,15969895,15971671,15970783,1776
8972,3483352,4,377656,377773,377714,117
8973,3483352,4,9444447,9444582,9444514,135
8974,3483353,1,622722,625021,623871,2299
8975,3483353,2,6032921,6033611,6033266,690
8976,3483353,3,16858806,16858917,16858861,111
8977,3483353,4,11352167,11354925,11353546,2758
8978,3483353,5,24900938,24901503,24901220,565
8979,3483354,1,7856718,7857121,7856919,403
8980,3483354,1,22067304,22070099,22068701,2795
8981,3483354,1,22802681,22803262,22802971,581
8982,3483354,2,1054826,1056377,1055601,1551
8983,3483354,2,15932708,15932880,15932794,172
8984,3483354,3,8215681,8216171,8215926,490
8985,3483354,4,7438926,7440565,7439745,1639
8986,3483354,5,20212189,20212202,20212195,13
8987,3483355,1,12247725,12248328,12248026,603
8988,3483355,3,8960780,8960959,8960869,179
8989,3483355,4,10507742,10507965,10507853,223
8990,3483355,5,9076436,9076686,9076561,250
8991,3483356,1,12544946,12545317,12545131,371
8992,3483356,1,19709755,19709815,19709785,60
8993,3483356,2,2180734,2181177,2180955,443
8994,3483356,2,12783204,12783726,12783465,522
8995,3483356,3,12659251,12662794,12661022,3543
8996,3483356,5,10239531,10239657,10239594,126
8997,3483357,1,8970919,8971286,8971102,367
8998,3483357,1,22276278,22276720,22276499,442
8999,3483357,1,25686202,25688463,25687332,2261
9000,3483357,3,7161973,7162167,7162070,194
9001,3483357,3,11207275,11207367,11207321,92
9002,3483357,4,5779053,5779085,5779069,32
9003,3483357,5,15992952,15992995,15992973,43
9004,3483358,1,6738976,6738979,6738977,3
9005,3483358,1,22304656,22304731,22304693,75
9006,3483358,2,12617232,12617592,12617412,360
9007,3483358,3,12450686,12450794,12450740,108
9008,3483358,3,19009342,19009750,19009546,408
9009,3483358,4,92785,92906,92845,121
9010,3483358,4,5145060,5145123,5145091,63
9011,3483358,4,18305056,18305109,18305082,53
9012,3483358,5,26249257,26249951,26249604,694
9013,3483359,1,10466543,10467009,10466776,466
9014,3483359,1,23688081,23688219,23688150,138
9015,3483359,3,5703643,5703689,5703666,46
9016,3483359,4,5379241,5379455,5379348,214
9017,3483359,5,10164432,10164720,10164576,288
9018,3483359,5,24464111,24464753,24464432,642
9019,3483360,1,4186823,4188341,4187582,1518
9020,3483360,1,13468281,13468902,13468591,621
9021,3483360,2,448398,448940,448669,542
9022,3483360,2,6652161,6653692,6652926,1531
9023,3483360,3,1732432,1732636,1732534,204
9024,3483360,4,10768368,10768817,10768592,449
9025,3483360,5,8768385,8768516,8768450,131
9026,3483360,5,9826312,9828490,9827401,2178
9027,3483361,2,7223806,7223978,7223892,172
9028,3483361,3,9297118,9297528,9297323,410
9029,3483361,3,17389741,17389752,17389746,11
9030,3483361,3,18027033,18027168,18027100,135
9031,3483361,4,11666438,11667358,11666898,920
9032,3483361,4,14977030,14977526,14977278,496
9033,3483361,5,10189485,10190302,10189893,817
9034,3483362,1,3748851,3749037,3748944,186
9035,3483362,1,10616789,10617415,10617102,626
9036,3483362,1,13056361,13061762,13059061,5401
9037,3483362,1,27329236,27329468,27329352,232
9038,3483362,2,1599223,1599289,1599256,66
9039,3483362,3,11277043,11277044,11277043,1
9040,3483362,4,112272,112334,112303,62
9041,3483362,5,8001939,8003067,8002503,1128
9042,3483363,1,11702354,11702386,11702370,32
9043,3483363,1,24340996,24341542,24341269,546
9044,3483363,2,2291752,2291982,2291867,230
9045,3483363,3,9046552,9046765,9046658,213
9046,3483363,4,7993073,7993107,7993090,34
9047,3483363,4,14523426,14523624,14523525,198
9048,3483363,5,16881844,16882212,16882028,368
9049,3483364,1,7744572,7744809,7744690,237
9050,3483364,1,9106846,9109017,9107931,2171
9051,3483364,2,6398255,6398348,6398301,93
9052,3483364,3,16581125,16581444,16581284,319
9053,3483364,4,1252017,1253273,1252645,1256
9054,3483364,4,15579344,15582971,15581157,3627
9055,3483364,5,10454682,10455378,10455030,696
9056,3483364,5,15825511,15826269,15825890,758
9057,3483364,5,26174289,26174853,26174571,564
9058,3483365,1,17599064,17599405,17599234,341
9059,3483365,2,11859177,11859329,11859253,152
9060,3483365,3,4374412,4375927,4375169,1515
9061,3483365,3,18499927,18500210,18500068,283
9062,3483365,4,1023218,1023562,1023390,344
9063,3483365,4,17392530,17393849,17393189,1319
9064,3483365,5,733600,734336,733968,736
9065,3483365,5,5995980,5997263,5996621,1283
9066,3483366,1,371972,372675,372323,703
9067,3483366,1,8136876,8137078,8136977,202
9068,3483366,2,10381894,10382269,10382081,375
9069,3483366,3,5510902,5512149,5511525,1247
9070,3483366,4,433383,433497,433440,114
9071,3483366,5,7550048,7550198,7550123,150
9072,3483366,5,9257686,9258981,9258333,1295
9073,3483366,5,15842641,15845095,15843868,2454
9074,3483367,1,2439590,2441778,2440684,2188
9075,3483367,1,22921777,22924665,22923221,2888
9076,3483367,2,13640032,13640115,13640073,83
9077,3483367,3,7594758,7595325,7595041,567
9078,3483367,3,16366756,16367037,16366896,281
9079,3483367,4,14847219,14847645,14847432,426
9080,3483367,5,2195262,2195750,2195506,488
9081,3483367,5,23268007,23268622,23268314,615
9082,3483368,1,24885832,24885854,24885843,22
9083,3483368,2,9514693,9515617,9515155,924
9084,3483368,2,18656755,18657240,18656997,485
9085,3483368,3,1516972,1522032,1519502,5060
9086,3483368,3,19574671,19574820,19574745,149
9087,3483368,4,7272687,7274195,7273441,1508
9088,3483369,1,3743416,3744550,3743983,1134
9089,3483369,2,1492785,1493004,1492894,219
9090,3483369,2,19010975,19013031,19012003,2056
9091,3483369,3,11790699,11790772,11790735,73
9092,3483369,5,16268718,16271231,16269974,2513
9093,3483369,5,18005535,18006503,18006019,968
9094,3483370,1,28416119,28417353,28416736,1234
9095,3483370,3,3138931,3139243,3139087,312
9096,3483370,3,8768022,8768826,8768424,804
9097,3483370,3,21838230,21847285,21842757,9055
9098,3483370,4,5318038,5318062,5318050,24
9099,3483370,4,15569081,15569347,15569214,266
9100,3483370,5,2981523,2981787,2981655,264
9101,3483370,5,17145954,17146535,17146244,581
9102,3483370,5,22971650,22971899,22971774,249
9103,3483371,1,24187873,24187891,24187882,18
9104,3483371,1,26351694,26351806,26351750,112
9105,3483371,2,9515829,9516312,9516070,483
9106,3483371,2,11228511,11231093,11229802,2582
9107,3483371,2,17629497,17629872,17629684,375
9108,3483371,3,11237473,11238496,11237984,1023
9109,3483371,5,5457767,5458009,5457888,242
9110,3483371,5,13933706,13933781,13933743,75
9111,3483372,1,12708448,12708696,12708572,248
9112,3483372,2,7597444,7597734,7597589,290
9113,3483372,3,16545060,16545469,16545264,409
9114,3483372,3,17584330,17584781,17584555,451
9115,3483372,4,10973055,10973238,10973146,183
9116,3483372,5,10296719,10299341,10298030,2622
9117,3483372,5,15257002,15258116,15257559,1114
9118,3483373,1,11448840,11449170,11449005,330
9119,3483373,2,6285965,6287891,6286928,1926
9120,3483373,2,9203086,9204799,9203942,1713
9121,3483373,3,1584064,1584102,1584083,38
9122,3483373,3,17516102,17516359,17516230,257
9123,3483373,3,23250252,23250553,23250402,301
9124,3483373,4,5196392,5196870,5196631,478
9125,3483373,5,669,793,731,124
9126,3483374,1,10939329,10940875,10940102,1546
9127,3483374,1,21648207,21648639,21648423,432
9128,3483374,2,1700015,1700235,1700125,220
9129,3483374,3,15334594,15335945,15335269,1351
9130,3483374,4,5386727,5386781,5386754,54
9131,3483374,5,4979346,4979766,4979556,420
9132,3483374,5,15850841,15851235,15851038,394
9133,3483375,1,2787761,2801647,2794704,13886
9134,3483375,1,10681643,10683356,10682499,1713
9135,3483375,1,29315974,29316467,29316220,493
9136,3483375,2,868048,869011,868529,963
9137,3483375,2,6006100,6006328,6006214,228
9138,3483375,3,1833444,1833836,1833640,392
9139,3483375,4,5377175,5378586,5377880,1411
9140,3483375,4,14493406,14494339,14493872,933
9141,3483375,5,7174882,7178907,7176894,4025
9142,3483375,5,15782332,15783220,15782776,888
9143,3483375,5,16943850,16944011,16943930,161
9144,3483376,1,2748640,2748910,2748775,270
9145,3483376,1,29175141,29175354,29175247,213
9146,3483376,2,493516,493537,493526,21
9147,3483376,2,14206394,14208210,14207302,1816
9148,3483376,3,1403879,1405005,1404442,1126
9149,3483376,3,6507620,6507634,6507627,14
9150,3483376,3,8966096,8966155,8966125,59
9151,3483376,3,19528164,19530993,19529578,2829
9152,3483376,4,390127,390891,390509,764
9153,3483376,5,1263936,1264138,1264037,202
9154,3483376,5,8445709,8445842,8445775,133
9155,3483377,1,8297613,8298417,8298015,804
9156,3483377,1,17858993,17859705,17859349,712
9157,3483377,1,26983654,26986571,26985112,2917
9158,3483377,2,242578,242636,242607,58
9159,3483377,2,16813581,16817826,16815703,4245
9160,3483377,3,6857013,6859329,6858171,2316
9161,3483377,3,10431706,10432254,10431980,548
9162,3483377,3,21037757,21042731,21040244,4974
9163,3483377,4,6517191,6517515,6517353,324
9164,3483377,5,21353184,21353480,21353332,296
9165,3483378,1,18797485,18797601,18797543,116
9166,3483378,2,6451025,6451890,6451457,865
9167,3483378,2,13779331,13782937,13781134,3606
9168,3483378,3,5066906,5066933,5066919,27
9169,3483378,3,21909794,21912239,21911016,2445
9170,3483378,4,5703915,5704374,5704144,459
9171,3483378,4,9336090,9338573,9337331,2483
9172,3483378,4,13720574,13721022,13720798,448
9173,3483378,5,7900780,7901399,7901089,619
9174,3483378,5,20980548,20980600,20980574,52
9175,3483379,2,9882390,9882658,9882524,268
9176,3483379,3,5649244,5649245,5649244,1
9177,3483379,3,23170265,23170730,23170497,465
9178,3483379,4,10709123,10710309,10709716,1186
9179,3483379,4,16469070,16474672,16471871,5602
9180,3483380,1,5383991,5384392,5384191,401
9181,3483380,1,28314640,28315680,28315160,1040
9182,3483380,2,7255782,7256731,7256256,949
9183,3483380,2,9720104,9720822,9720463,718
9184,3483380,3,9200946,9200962,9200954,16
9185,3483380,5,977816,978222,978019,406
9186,3483380,5,16803923,16804319,16804121,396
9187,3483381,1,9844262,9844482,9844372,220
9188,3483381,1,19461023,19467837,19464430,6814
9189,3483381,1,27529678,27529916,27529797,238
9190,3483381,2,9895092,9895343,9895217,251
9191,3483381,2,15966332,15967927,15967129,1595
9192,3483381,3,11096377,11096565,11096471,188
9193,3483381,4,1465100,1465412,1465256,312
9194,3483381,4,5341750,5342103,5341926,353
9195,3483381,5,417644,419049,418346,1405
9196,3483381,5,6379461,6379714,6379587,253
9197,3483382,2,5386259,5386294,5386276,35
9198,3483382,2,17822618,17824070,17823344,1452
9199,3483382,3,3040492,3041090,3040791,598
9200,3483382,3,11512693,11512787,11512740,94
9201,3483382,3,16204203,16204219,16204211,16
9202,3483382,4,8122665,8123210,8122937,545
9203,3483382,4,8212799,8212848,8212823,49
9204,3483382,5,14929297,14929951,14929624,654
9205,3483383,3,11781091,11781426,11781258,335
9206,3483383,3,20774202,20774367,20774284,165
9207,3483383,4,17577886,17578612,17578249,726
9208,3483383,5,9521901,9521934,9521917,33
9209,3483383,5,15400024,15400407,15400215,383
9210,3483383,5,16708335,16708476,16708405,141
9211,3483384,2,19150254,19150593,19150423,339
9212,3483384,3,5889015,5891680,5890347,2665
9213,3483384,3,11720789,11721099,11720944,310
9214,3483384,3,17998923,17998989,17998956,66
9215,3483384,4,7257361,7257487,7257424,126
9216,3483384,5,5994710,5995980,5995345,1270
9217,3483384,5,14090348,14090750,14090549,402
9218,3483384,5,14528402,14530678,14529540,2276
9219,3483384,5,14796826,14796977,14796901,151
9220,3483384,5,18925936,18926048,18925992,112
9221,3483385,1,18451216,18451463,18451339,247
9222,3483385,2,329198,332300,330749,3102
9223,3483385,2,7359849,7360495,7360172,646
9224,3483385,3,8910864,8910934,8910899,70
9225,3483385,4,930383,931527,930955,1144
9226,3483385,4,8892026,8892270,8892148,244
9227,3483385,5,737142,737384,737263,242
9228,3483385,5,21976513,21977408,21976960,895
9229,3483386,1,9881296,9881352,9881324,56
9230,3483386,1,12514546,12515051,12514798,505
9231,3483386,2,1181511,1181523,1181517,12
9232,3483386,2,6480928,6481791,6481359,863
9233,3483386,2,19334555,19334748,19334651,193
9234,3483386,3,16531603,16533277,16532440,1674
9235,3483386,4,10699164,10699452,10699308,288
9236,3483386,5,7954292,7956287,7955289,1995
9237,3483386,5,8527678,8527705,8527691,27
9238,3483386,5,21383162,21386142,21384652,2980
9239,3483386,5,24934839,24936028,24935433,1189
9240,3483386,5,25634603,25635239,25634921,636
9241,3483387,1,1529592,1529709,1529650,117
9242,3483387,1,19814714,19816257,19815485,1543
9243,3483387,1,29334887,29337106,29335996,2219
9244,3483387,3,6753926,6754140,6754033,214
9245,3483387,3,11789317,11790772,11790044,1455
9246,3483387,5,8013476,8013700,8013588,224
9247,3483387,5,9571509,9572687,9572098,1178
9248,3483387,5,20482786,20483732,20483259,946
9249,3483387,5,21112231,21112435,21112333,204
9250,3483388,1,17335349,17335500,17335424,151
9251,3483388,1,24249859,24250519,24250189,660
9252,3483388,2,9698185,9698461,9698323,276
9253,3483388,2,17108224,17109106,17108665,882
9254,3483388,3,15966976,15967176,15967076,200
9255,3483388,3,16020128,16020275,16020201,147
9256,3483388,4,1060206,1060296,1060251,90
9257,3483388,4,6247516,6248164,6247840,648
9258,3483388,5,564532,565504,565018,972
9259,3483389,1,10610021,10610317,10610169,296
9260,3483389,1,17482076,17484564,17483320,2488
9261,3483389,1,27141059,27141778,27141418,719
9262,3483389,2,8183508,8183562,8183535,54
9263,3483389,2,9716617,9716739,9716678,122
9264,3483389,2,18465504,18466605,18466054,1101
9265,3483389,3,136344,137527,136935,1183
9266,3483389,3,7601915,7601969,7601942,54
9267,3483389,5,2184556,2184572,2184564,16
9268,3483389,5,15261486,15263021,15262253,1535
9269,3483389,5,16597126,16597298,16597212,172
9270,3483389,5,21718434,21719531,21718982,1097
9271,3483390,1,1562334,1562356,1562345,22
9272,3483390,1,17295097,17295100,17295098,3
9273,3483390,2,2294138,2294167,2294152,29
9274,3483390,3,18428383,18429734,18429058,1351
9275,3483390,4,615549,615629,615589,80
9276,3483390,4,7340317,7340364,7340340,47
9277,3483390,5,9458251,9459538,9458894,1287
9278,3483391,1,4780515,4780613,4780564,98
9279,3483391,2,6385364,6385409,6385386,45
9280,3483391,3,2887350,2887800,2887575,450
9281,3483391,4,17116747,17117241,17116994,494
9282,3483391,5,15007044,15008683,15007863,1639
9283,3483392,2,750574,750593,750583,19
9284,3483392,2,783797,787712,785754,3915
9285,3483392,4,86622,87255,86938,633
9286,3483392,5,3405494,3406108,3405801,614
9287,3483392,5,6061335,6061837,6061586,502
9288,3483392,5,15788863,15788868,15788865,5
9289,3483393,1,10209791,10211457,10210624,1666
9290,3483393,1,11468661,11468736,11468698,75
9291,3483393,1,26732602,26734979,26733790,2377
9292,3483393,2,13953065,13953841,13953453,776
9293,3483393,3,8647510,8647596,8647553,86
9294,3483393,3,11729668,11729924,11729796,256
9295,3483393,4,884457,884488,884472,31
9296,3483393,4,7365621,7366048,7365834,427
9297,3483393,5,5133096,5133357,5133226,261
9298,3483393,5,7825571,7826741,7826156,1170
9299,3483393,5,22873081,22873108,22873094,27
9300,3483394,3,19574671,19575572,19575121,901
9301,3483394,4,197853,198239,198046,386
9302,3483394,4,5425362,5425377,5425369,15
9303,3483394,5,1601661,1602678,1602169,1017
9304,3483395,1,7502755,7503589,7503172,834
9305,3483395,2,12285519,12285530,12285524,11
9306,3483395,3,6906574,6907138,6906856,564
9307,3483395,4,624630,625415,625022,785
9308,3483395,4,11673325,11674206,11673765,881
9309,3483395,5,25126957,25127228,25127092,271
9310,3483396,1,1550655,1550920,1550787,265
9311,3483396,1,17327253,17328165,17327709,912
9312,3483396,1,18131031,18131072,18131051,41
9313,3483396,2,256238,256331,256284,93
9314,3483396,3,16569271,16569407,16569339,136
9315,3483396,5,24311084,24311828,24311456,744
9316,3483397,1,10351539,10351606,10351572,67
9317,3483397,1,21097075,21097258,21097166,183
9318,3483397,1,27101504,27101512,27101508,8
9319,3483397,2,162552,162726,162639,174
9320,3483397,2,1679090,1679153,1679121,63
9321,3483397,3,7148161,7148614,7148387,453
9322,3483397,4,7285374,7285536,7285455,162
9323,3483397,5,576458,576612,576535,154
9324,3483397,5,1598062,1598180,1598121,118
9325,3483398,1,28169678,28170031,28169854,353
9326,3483398,2,6802673,6805048,6803860,2375
9327,3483398,2,15682550,15682578,15682564,28
9328,3483398,3,21809,23291,22550,1482
9329,3483398,3,9401638,9401770,9401704,132
9330,3483398,4,5357584,5358187,5357885,603
9331,3483398,4,7747731,7748377,7748054,646
9332,3483398,4,18302629,18302750,18302689,121
9333,3483398,5,8723286,8723672,8723479,386
9334,3483399,1,7827397,7827448,7827422,51
9335,3483399,1,26818560,26820348,26819454,1788
9336,3483399,1,29252293,29255461,29253877,3168
9337,3483399,2,2230932,2230966,2230949,34
9338,3483399,2,10296822,10297439,10297130,617
9339,3483399,2,16315713,16317948,16316830,2235
9340,3483399,3,2857360,2858901,2858130,1541
9341,3483399,3,7607786,7607855,7607820,69
9342,3483399,3,8229263,8229378,8229320,115
9343,3483399,3,18206229,18207691,18206960,1462
9344,3483399,4,5659533,5659554,5659543,21
9345,3483399,5,26024125,26028311,26026218,4186
9346,3483400,1,6787092,6787107,6787099,15
9347,3483400,2,661709,661989,661849,280
9348,3483400,2,6693217,6693474,6693345,257
9349,3483400,2,16645983,16646375,16646179,392
9350,3483400,3,16868540,16868622,16868581,82
9351,3483400,4,6858404,6858669,6858536,265
9352,3483400,5,10749016,10749119,10749067,103
9353,3483400,5,14121095,14121119,14121107,24
9354,3483400,5,26754565,26754603,26754584,38
9355,3483401,1,12536143,12536172,12536157,29
9356,3483401,1,16594063,16594181,16594122,118
9357,3483401,2,5706706,5706797,5706751,91
9358,3483401,3,11104534,11105372,11104953,838
9359,3483401,3,15707253,15707874,15707563,621
9360,3483401,5,6368036,6370647,6369341,2611
9361,3483401,5,13884274,13884377,13884325,103
9362,3483402,1,8172229,8172674,8172451,445
9363,3483402,1,21335443,21337266,21336354,1823
9364,3483402,3,9524147,9524214,9524180,67
9365,3483402,5,2006913,2007745,2007329,832
9366,3483402,5,13635425,13635564,13635494,139
9367,3483403,1,7854491,7854880,7854685,389
9368,3483403,2,6214993,6215132,6215062,139
9369,3483403,4,7518469,7518964,7518716,495
9370,3483403,5,9081030,9081274,9081152,244
9371,3483403,5,24333602,24334507,24334054,905
9372,3483404,1,1425648,1425813,1425730,165
9373,3483404,1,11119785,11120082,11119933,297
9374,3483404,1,26371091,26371807,26371449,716
9375,3483404,3,847759,848845,848302,1086
9376,3483404,3,10735226,10735371,10735298,145
9377,3483404,3,23092030,23092509,23092269,479
9378,3483404,5,19533670,19533838,19533754,168
9379,3483405,1,27700269,27700687,27700478,418
9380,3483405,2,273849,274038,273943,189
9381,3483405,3,17913977,17914851,17914414,874
9382,3483405,4,7266358,7266702,7266530,344
9383,3483405,4,18106135,18106794,18106464,659
9384,3483405,5,8098626,8108936,8103781,10310
9385,3483405,5,14842815,14842870,14842842,55
9386,3483405,5,19165574,19167581,19166577,2007
9387,3483406,1,6875633,6877938,6876785,2305
9388,3483406,1,17477606,17477781,17477693,175
9389,3483406,2,10409936,10410220,10410078,284
9390,3483406,3,17849627,17850322,17849974,695
9391,3483406,5,22334204,22334828,22334516,624
9392,3483407,1,23743949,23744568,23744258,619
9393,3483407,2,12256879,12257376,12257127,497
9394,3483407,3,11997571,11998272,11997921,701
9395,3483407,4,5603257,5603298,5603277,41
9396,3483407,4,14977030,14977526,14977278,496
9397,3483407,5,6392226,6392785,6392505,559
9398,3483407,5,13750276,13750806,13750541,530
9399,3483408,1,19435940,19435944,19435942,4
9400,3483408,2,5956515,5956540,5956527,25
9401,3483408,3,15655904,15656201,15656052,297
9402,3483408,5,15501737,15501868,15501802,131
9403,3483409,1,7004682,7004739,7004710,57
9404,3483409,1,8988175,8988547,8988361,372
9405,3483409,1,17530358,17530389,17530373,31
9406,3483409,1,24554817,24554841,24554829,24
9407,3483409,1,25711960,25712974,25712467,1014
9408,3483409,3,2892205,2892326,2892265,121
9409,3483409,3,10746434,10746595,10746514,161
9410,3483409,3,11225558,11227185,11226371,1627
9411,3483409,4,195726,196614,196170,888
9412,3483409,4,7790174,7790213,7790193,39
9413,3483409,5,7703172,7703201,7703186,29
9414,3483409,5,14526669,14527697,14527183,1028
9415,3483409,5,23058377,23058586,23058481,209
9416,3483410,1,9453979,9455685,9454832,1706
9417,3483410,1,18036884,18037192,18037038,308
9418,3483410,1,25625722,25626097,25625909,375
9419,3483410,2,5925279,5925380,5925329,101
9420,3483410,2,10744041,10744317,10744179,276
9421,3483410,3,12770361,12771252,12770806,891
9422,3483410,4,6991195,6991390,6991292,195
9423,3483410,4,10169024,10169159,10169091,135
9424,3483410,4,17628544,17629291,17628917,747
9425,3483410,5,21893821,21894054,21893937,233
9426,3483411,1,17266212,17266547,17266379,335
9427,3483411,1,22066794,22066818,22066806,24
9428,3483411,2,1438997,1440785,1439891,1788
9429,3483411,2,11589541,11590216,11589878,675
9430,3483411,2,19017749,19019256,19018502,1507
9431,3483411,3,7148341,7148614,7148477,273
9432,3483411,3,11499816,11499916,11499866,100
9433,3483411,4,1209490,1209589,1209539,99
9434,3483411,4,1516194,1517234,1516714,1040
9435,3483411,4,13721022,13723073,13722047,2051
9436,3483411,5,5964137,5964729,5964433,592
9437,3483411,5,20450656,20451057,20450856,401
9438,3483412,1,10578194,10580117,10579155,1923
9439,3483412,2,6590275,6597506,6593890,7231
9440,3483412,3,9132483,9133195,9132839,712
9441,3483412,3,18513032,18513701,18513366,669
9442,3483412,4,408143,408246,408194,103
9443,3483412,5,661207,661229,661218,22
9444,3483412,5,1315573,1316006,1315789,433
9445,3483412,5,3243055,3243073,3243064,18
9446,3483412,5,25035887,25038001,25036944,2114
9447,3483413,1,7854251,7854465,7854358,214
9448,3483413,1,11075313,11076898,11076105,1585
9449,3483413,1,21150402,21150540,21150471,138
9450,3483413,2,7041178,7041221,7041199,43
9451,3483413,3,16566659,16566849,16566754,190
9452,3483413,4,620506,623123,621814,2617
9453,3483413,5,338411,338665,338538,254
9454,3483413,5,18164504,18165618,18165061,1114
9455,3483413,5,25999010,25999166,25999088,156
9456,3483414,1,708773,709476,709124,703
9457,3483414,1,6635348,6636247,6635797,899
9458,3483414,1,27745399,27745640,27745519,241
9459,3483414,2,9753263,9753421,9753342,158
9460,3483414,2,19205183,19205320,19205251,137
9461,3483414,3,8688688,8690574,8689631,1886
9462,3483414,3,19268824,19269156,19268990,332
9463,3483414,4,943204,943394,943299,190
9464,3483414,4,17032191,17032533,17032362,342
9465,3483414,5,13652510,13652592,13652551,82
9466,3483415,1,27106192,27108026,27107109,1834
9467,3483415,2,452248,452544,452396,296
9468,3483415,2,8234120,8235310,8234715,1190
9469,3483415,2,15511012,15512311,15511661,1299
9470,3483415,3,8474396,8474685,8474540,289
9471,3483415,3,21274997,21275415,21275206,418
9472,3483415,4,11613142,11613470,11613306,328
9473,3483415,5,18637845,18639121,18638483,1276
9474,3483415,5,24813021,24813502,24813261,481
9475,3483416,1,2595453,2596142,2595797,689
9476,3483416,1,28957740,28958346,28958043,606
9477,3483416,3,8890647,8891532,8891089,885
9478,3483416,3,20449058,20449136,20449097,78
9479,3483416,4,188702,189437,189069,735
9480,3483416,4,9926386,9926430,9926408,44
9481,3483416,5,9059171,9059347,9059259,176
9482,3483417,1,9993836,9993848,9993842,12
9483,3483417,1,26538046,26539239,26538642,1193
9484,3483417,1,29535307,29536633,29535970,1326
9485,3483417,3,18367185,18367214,18367199,29
9486,3483417,4,5660121,5660231,5660176,110
9487,3483417,4,8789963,8790368,8790165,405
9488,3483417,4,17392002,17392147,17392074,145
9489,3483417,5,19118860,19119700,19119280,840
9490,3483418,1,24617881,24618107,24617994,226
9491,3483418,2,5493687,5508992,5501339,15305
9492,3483418,2,10525197,10525214,10525205,17
9493,3483418,4,8882034,8882170,8882102,136
9494,3483418,5,578351,578423,578387,72
9495,3483418,5,17165576,17165603,17165589,27
9496,3483419,1,10302681,10302981,10302831,300
9497,3483419,2,12784025,12785490,12784757,1465
9498,3483419,3,18866456,18868953,18867704,2497
9499,3483419,5,652039,653377,652708,1338
9500,3483420,1,9094927,9094944,9094935,17
9501,3483420,2,6879650,6879664,6879657,14
9502,3483420,3,10631041,10631098,10631069,57
9503,3483420,3,21065174,21065307,21065240,133
9504,3483420,5,3989084,3989940,3989512,856
9505,3483421,1,2801771,2802301,2802036,530
9506,3483421,1,6870832,6871182,6871007,350
9507,3483421,1,22585044,22586032,22585538,988
9508,3483421,2,7711877,7712869,7712373,992
9509,3483421,3,19016226,19016484,19016355,258
9510,3483421,5,978449,978512,978480,63
9511,3483421,5,21377019,21378398,21377708,1379
9512,3483421,5,25220209,25221905,25221057,1696
9513,3483422,1,702818,703327,703072,509
9514,3483422,1,26767412,26768271,26767841,859
9515,3483422,2,2269335,2269364,2269349,29
9516,3483422,2,11313581,11314783,11314182,1202
9517,3483422,3,9706275,9706957,9706616,682
9518,3483422,3,17005653,17005691,17005672,38
9519,3483422,4,7064930,7065409,7065169,479
9520,3483422,5,6845335,6847192,6846263,1857
9521,3483422,5,25134905,25135356,25135130,451
9522,3483423,1,9101761,9101985,9101873,224
9523,3483423,1,18265498,18265647,18265572,149
9524,3483423,1,29781259,29781590,29781424,331
9525,3483423,2,806790,806977,806883,187
9526,3483423,2,14585003,14585182,14585092,179
9527,3483423,2,18604474,18606226,18605350,1752
9528,3483423,3,7362159,7362707,7362433,548
9529,3483423,3,18608489,18608816,18608652,327
9530,3483423,4,1153348,1154102,1153725,754
9531,3483423,4,17432191,17432639,17432415,448
9532,3483423,5,3505215,3505616,3505415,401
9533,3483424,1,614273,617800,616036,3527
9534,3483424,1,9695933,9696309,9696121,376
9535,3483424,1,11053951,11054181,11054066,230
9536,3483424,1,13079378,13079617,13079497,239
9537,3483424,1,25648968,25649213,25649090,245
9538,3483424,2,11082441,11082800,11082620,359
9539,3483424,3,2434875,2435529,2435202,654
9540,3483424,3,11100706,11102632,11101669,1926
9541,3483424,3,22907368,22908358,22907863,990
9542,3483424,5,8981409,8981546,8981477,137
9543,3483424,5,17805261,17805552,17805406,291
9544,3483424,5,25447525,25448167,25447846,642
9545,3483425,1,12645175,12645355,12645265,180
9546,3483425,2,2902129,2908284,2905206,6155
9547,3483425,3,7646891,7647092,7646991,201
9548,3483425,4,179821,179908,179864,87
9549,3483425,4,7392916,7393687,7393301,771
9550,3483425,5,22621711,22621887,22621799,176
9551,3483426,2,6355635,6356174,6355904,539
9552,3483426,3,10947416,10949969,10948692,2553
9553,3483426,3,16803397,16803415,16803406,18
9554,3483426,4,7433984,7434017,7434000,33
9555,3483426,4,16648788,16649432,16649110,644
9556,3483426,5,23265822,23265827,23265824,5
9557,3483427,1,8046881,8050375,8048628,3494
9558,3483427,1,19043546,19043833,19043689,287
9559,3483427,3,10699274,10699328,10699301,54
9560,3483427,5,15214102,15214304,15214203,202
9561,3483427,5,16294244,16294843,16294543,599
9562,3483427,5,18954506,18954575,18954540,69
9563,3483428,2,997490,997581,997535,91
9564,3483428,2,15154598,15157341,15155969,2743
9565,3483428,3,11102632,11102654,11102643,22
9566,3483428,3,19990482,19991246,19990864,764
9567,3483428,5,829322,829572,829447,250
9568,3483428,5,15261318,15261406,15261362,88
9569,3483429,1,9480823,9480827,9480825,4
9570,3483429,1,25724322,25724742,25724532,420
9571,3483429,2,5816685,5820226,5818455,3541
9572,3483429,2,19351105,19351563,19351334,458
9573,3483429,3,661236,661409,661322,173
9574,3483429,4,5739140,5739244,5739192,104
9575,3483429,5,10381451,10381801,10381626,350
9576,3483429,5,23312159,23312636,23312397,477
9577,3483430,1,17526986,17527731,17527358,745
9578,3483430,1,29522028,29523813,29522920,1785
9579,3483430,2,9578585,9579108,9578846,523
9580,3483430,2,16244080,16246535,16245307,2455
9581,3483430,3,7881253,7881653,7881453,400
9582,3483430,3,10034558,10034655,10034606,97
9583,3483430,4,578631,578775,578703,144
9584,3483430,4,7722364,7722525,7722444,161
9585,3483430,5,4188954,4189090,4189022,136
9586,3483430,5,8679904,8682275,8681089,2371
9587,3483430,5,17935458,17935629,17935543,171
9588,3483431,1,10200716,10201406,10201061,690
9589,3483431,1,19639527,19640966,19640246,1439
9590,3483431,2,2100147,2100174,2100160,27
9591,3483431,3,21295337,21295996,21295666,659
9592,3483431,5,20724592,20724766,20724679,174
9593,3483432,1,9883410,9883491,9883450,81
9594,3483432,1,16730922,16730929,16730925,7
9595,3483432,1,29387658,29387758,29387708,100
9596,3483432,2,10611630,10611728,10611679,98
9597,3483432,3,15880704,15880765,15880734,61
9598,3483432,4,13126375,13128387,13127381,2012
9599,3483432,4,17118843,17119450,17119146,607
9600,3483432,5,3914108,3914246,3914177,138
9601,3483433,1,16913640,16913694,16913667,54
9602,3483433,1,24885934,24886006,24885970,72
9603,3483433,3,1174416,1174871,1174643,455
9604,3483433,3,16814331,16814541,16814436,210
9605,3483433,3,17378404,17378560,17378482,156
9606,3483433,4,5731037,5734505,5732771,3468
9607,3483433,4,9828173,9828952,9828562,779
9608,3483433,5,14628423,14628801,14628612,378
9609,3483434,1,6871474,6871759,6871616,285
9610,3483434,1,7692513,7693014,7692763,501
9611,3483434,1,24528444,24528864,24528654,420
9612,3483434,1,28876392,28877269,28876830,877
9613,3483434,2,992674,993099,992886,425
9614,3483434,2,15687780,15689093,15688436,1313
9615,3483434,3,5176451,5177902,5177176,1451
9616,3483434,3,7866577,7867266,7866921,689
9617,3483434,4,10219483,10219858,10219670,375
9618,3483434,5,13771093,13771616,13771354,523
9619,3483434,5,16238131,16238561,16238346,430
9620,3483435,1,5129240,5129372,5129306,132
9621,3483435,1,13050241,13050494,13050367,253
9622,3483435,1,29838681,29838816,29838748,135
9623,3483435,1,30417499,30417616,30417557,117
9624,3483435,2,9846086,9846129,9846107,43
9625,3483435,4,7854243,7855899,7855071,1656
9626,3483435,5,9878222,9878325,9878273,103
9627,3483435,5,14011038,14011257,14011147,219
9628,3483435,5,26753862,26754269,26754065,407
9629,3483436,1,3801193,3801662,3801427,469
9630,3483436,1,7347555,7347971,7347763,416
9631,3483436,1,12542623,12544302,12543462,1679
9632,3483436,1,24499035,24499381,24499208,346
9633,3483436,2,1641921,1641927,1641924,6
9634,3483436,2,15499000,15499012,15499006,12
9635,3483436,3,1006022,1008270,1007146,2248
9636,3483436,4,5373925,5373979,5373952,54
9637,3483436,5,5833749,5834044,5833896,295
9638,3483436,5,25006335,25006439,25006387,104
9639,3483436,5,25999010,25999166,25999088,156
9640,3483437,1,12659541,12659574,12659557,33
9641,3483437,1,17276219,17276613,17276416,394
9642,3483437,2,14068806,14070175,14069490,1369
9643,3483437,2,15010411,15011517,15010964,1106
9644,3483437,3,3051117,3052691,3051904,1574
9645,3483437,3,17936007,17936672,17936339,665
9646,3483437,5,8756505,8757639,8757072,1134
9647,3483437,5,17584964,17585038,17585001,74
9648,3483437,5,21405235,21406614,21405924,1379
9649,3483438,1,562199,562860,562529,661
9650,3483438,1,3400021,3400376,3400198,355
9651,3483438,1,12263002,12263020,12263011,18
9652,3483438,1,12956029,12956176,12956102,147
9653,3483438,1,26728903,26728982,26728942,79
9654,3483438,2,15283162,15283977,15283569,815
9655,3483438,3,2349512,2350091,2349801,579
9656,3483438,3,9833701,9834835,9834268,1134
9657,3483438,3,16537500,16537585,16537542,85
9658,3483438,4,9382851,9383208,9383029,357
9659,3483438,5,8031090,8031415,8031252,325
9660,3483438,5,8261891,8262014,8261952,123
9661,3483438,5,26355561,26355665,26355613,104
9662,3483439,1,6775719,6775874,6775796,155
9663,3483439,1,8923849,8924033,8923941,184
9664,3483439,1,18042158,18043077,18042617,919
9665,3483439,1,25443938,25445123,25444530,1185
9666,3483439,4,412810,412959,412884,149
9667,3483439,4,8855177,8855202,8855189,25
9668,3483439,4,17112032,17113382,17112707,1350
9669,3483439,5,2268156,2268860,2268508,704
9670,3483439,5,22724828,22727062,22725945,2234
9671,3483440,1,12607954,12608114,12608034,160
9672,3483440,1,21902584,21903468,21903026,884
9673,3483440,2,17245423,17246457,17245940,1034
9674,3483440,3,7801008,7801484,7801246,476
9675,3483440,3,8963645,8963926,8963785,281
9676,3483440,4,1215532,1215601,1215566,69
9677,3483440,4,5338242,5338730,5338486,488
9678,3483440,4,6749271,6749289,6749280,18
9679,3483440,4,16457772,16457880,16457826,108
9680,3483440,5,533707,533715,533711,8
9681,3483441,3,9372485,9372570,9372527,85
9682,3483441,4,880664,881886,881275,1222
9683,3483441,4,12230497,12232092,12231294,1595
9684,3483441,5,283476,283541,283508,65
9685,3483441,5,24129901,24132719,24131310,2818
9686,3483442,1,4249346,4249364,4249355,18
9687,3483442,1,11770136,11771357,11770746,1221
9688,3483442,1,27553107,27553234,27553170,127
9689,3483442,2,18493791,18494119,18493955,328
9690,3483442,3,9311242,9311270,9311256,28
9691,3483442,4,1040391,1040573,1040482,182
9692,3483442,4,16144099,16144435,16144267,336
9693,3483442,5,13933285,13933706,13933495,421
9694,3483442,5,18798176,18799496,18798836,1320
9695,3483443,1,24523416,24524851,24524133,1435
9696,3483443,5,9812749,9812993,9812871,244
9697,3483444,1,8341205,8342139,8341672,934
9698,3483444,1,24852018,24853135,24852576,1117
9699,3483444,2,2896219,2896598,2896408,379
9700,3483444,2,5494228,5496117,5495172,1889
9701,3483444,2,19010800,19010975,19010887,175
9702,3483444,3,6219432,6220524,6219978,1092
9703,3483444,3,7282747,7284148,7283447,1401
9704,3483444,3,18757656,18757936,18757796,280
9705,3483444,5,787181,788312,787746,1131
9706,3483445,1,25223023,25223435,25223229,412
9707,3483445,2,14122008,14122605,14122306,597
9708,3483445,3,8762713,8763225,8762969,512
9709,3483445,3,9635835,9635839,9635837,4
9710,3483445,5,747110,748751,747930,1641
9711,3483445,5,7259032,7260288,7259660,1256
9712,3483446,1,12465822,12465845,12465833,23
9713,3483446,1,23500786,23504812,23502799,4026
9714,3483446,2,1570382,1570633,1570507,251
9715,3483446,2,6518513,6518677,6518595,164
9716,3483446,2,15173269,15173454,15173361,185
9717,3483446,3,2572710,2572899,2572804,189
9718,3483446,4,17371723,17372275,17371999,552
9719,3483446,5,22518861,22519901,22519381,1040
9720,3483447,1,4778131,4779155,4778643,1024
9721,3483447,1,17413420,17414530,17413975,1110
9722,3483447,2,493537,493650,493593,113
9723,3483447,2,6017200,6018166,6017683,966
9724,3483447,3,195332,195879,195605,547
9725,3483447,4,5338752,5341521,5340136,2769
9726,3483447,4,6182284,6182501,6182392,217
9727,3483447,5,10262654,10262872,10262763,218
9728,3483447,5,13231455,13232179,13231817,724
9729,3483448,1,3621563,3622506,3622034,943
9730,3483448,1,20702449,20702570,20702509,121
9731,3483448,4,11550901,11552896,11551898,1995
9732,3483449,1,28586256,28587355,28586805,1099
9733,3483449,2,83573,83764,83668,191
9734,3483449,2,2188987,2189111,2189049,124
9735,3483449,2,18591928,18592320,18592124,392
9736,3483449,3,11920382,11921142,11920762,760
9737,3483449,3,19970728,19972662,19971695,1934
9738,3483449,4,5371418,5371919,5371668,501
9739,3483449,4,7025538,7025829,7025683,291
9740,3483449,4,12273621,12273784,12273702,163
9741,3483449,5,14145076,14151864,14148470,6788
9742,3483450,1,19093713,19094912,19094312,1199
9743,3483450,1,27590745,27590851,27590798,106
9744,3483450,3,17124775,17124823,17124799,48
9745,3483450,4,12066837,12067116,12066976,279
9746,3483450,5,14949752,14949888,14949820,136
9747,3483451,1,11925560,11925561,11925560,1
9748,3483451,1,22560672,22560690,22560681,18
9749,3483451,1,26143033,26143168,26143100,135
9750,3483451,2,12138097,12140462,12139279,2365
9751,3483451,2,15381778,15382239,15382008,461
9752,3483451,3,5243993,5244340,5244166,347
9753,3483451,3,10959065,10959696,10959380,631
9754,3483451,3,15688632,15688729,15688680,97
9755,3483451,4,5725043,5725304,5725173,261
9756,3483451,5,8226006,8226077,8226041,71
9757,3483451,5,10263318,10263540,10263429,222
9758,3483451,5,17530805,17531032,17530918,227
9759,3483452,1,4868499,4869764,4869131,1265
9760,3483452,1,20950307,20950389,20950348,82
9761,3483452,2,18799992,18800156,18800074,164
9762,3483452,3,1859390,1859883,1859636,493
9763,3483452,3,4370569,4370825,4370697,256
9764,3483452,3,6260892,6261454,6261173,562
9765,3483452,5,10447158,10447245,10447201,87
9766,3483452,5,22187911,22187925,22187918,14
9767,3483452,5,24787645,24787797,24787721,152
9768,3483453,1,730948,732827,731887,1879
9769,3483453,1,12540842,12541146,12540994,304
9770,3483453,1,20690942,20691083,20691012,141
9771,3483453,1,26435995,26439361,26437678,3366
9772,3483453,2,10459019,10459135,10459077,116
9773,3483453,2,16764933,16765206,16765069,273
9774,3483453,3,5761417,5761598,5761507,181
9775,3483453,4,5710593,5710760,5710676,167
9776,3483453,4,16073760,16075050,16074405,1290
9777,3483453,5,1139548,1140076,1139812,528
9778,3483453,5,18997752,18997831,18997791,79
9779,3483453,5,22180156,22180806,22180481,650
9780,3483454,1,624722,625021,624871,299
9781,3483454,2,12146763,12147090,12146926,327
9782,3483454,3,19856074,19857900,19856987,1826
9783,3483454,4,5142540,5142950,5142745,410
9784,3483454,4,9553422,9553429,9553425,7
9785,3483454,5,9935011,9935039,9935025,28
9786,3483454,5,13702713,13703158,13702935,445
9787,3483455,1,7146018,7146305,7146161,287
9788,3483455,1,11728959,11728987,11728973,28
9789,3483455,1,26431547,26432045,26431796,498
9790,3483455,1,26519303,26521603,26520453,2300
9791,3483455,2,564784,565095,564939,311
9792,3483455,2,10194464,10194659,10194561,195
9793,3483455,2,10669099,10669763,10669431,664
9794,3483455,3,166078,166464,166271,386
9795,3483455,4,181484,184086,182785,2602
9796,3483455,4,4887026,4887549,4887287,523
9797,3483455,4,14975325,14975495,14975410,170
9798,3483455,5,18377609,18377845,18377727,236
9799,3483455,5,21214493,21214638,21214565,145
9800,3483456,1,13226435,13227215,13226825,780
9801,3483456,3,5413889,5415781,5414835,1892
9802,3483456,3,10306909,10307191,10307050,282
9803,3483456,4,306715,306895,306805,180
9804,3483456,5,18394371,18394939,18394655,568
9805,3483457,2,7873125,7873890,7873507,765
9806,3483457,2,9987872,9988726,9988299,854
9807,3483457,2,18512470,18512595,18512532,125
9808,3483457,3,321598,322797,322197,1199
9809,3483457,3,11100136,11100239,11100187,103
9810,3483457,3,18512806,18513032,18512919,226
9811,3483457,4,87323,88852,88087,1529
9812,3483457,4,11384861,11386019,11385440,1158
9813,3483457,4,17582396,17582667,17582531,271
9814,3483457,5,10089022,10090011,10089516,989
9815,3483458,1,6042166,6042386,6042276,220
9816,3483458,1,17229039,17229124,17229081,85
9817,3483458,1,24885934,24886006,24885970,72
9818,3483458,1,27143228,27143884,27143556,656
9819,3483458,2,10331364,10331873,10331618,509
9820,3483458,3,7968216,7968489,7968352,273
9821,3483458,4,291532,291877,291704,345
9822,3483458,4,10588640,10588695,10588667,55
9823,3483458,4,11722887,11722896,11722891,9
9824,3483458,5,14532981,14533319,14533150,338
9825,3483458,5,25998542,25999010,25998776,468
9826,3483459,2,1006907,1007797,1007352,890
9827,3483459,3,8025189,8026329,8025759,1140
9828,3483459,3,9311869,9312415,9312142,546
9829,3483459,4,421284,421338,421311,54
9830,3483459,4,7255668,7255750,7255709,82
9831,3483459,4,10440019,10440048,10440033,29
9832,3483459,5,5138495,5140623,5139559,2128
9833,3483459,5,5838637,5839314,5838975,677
9834,3483460,1,9453225,9453431,9453328,206
9835,3483460,1,16004927,16005092,16005009,165
9836,3483460,3,3309571,3309638,3309604,67
9837,3483460,3,16629477,16629693,16629585,216
9838,3483460,4,360298,360353,360325,55
9839,3483460,4,12610362,12610531,12610446,169
9840,3483460,5,7376381,7377681,7377031,1300
9841,3483460,5,22177356,22177853,22177604,497
9842,3483461,1,25733368,25733378,25733373,10
9843,3483461,2,6640875,6641128,6641001,253
9844,3483461,3,11282418,11282749,11282583,331
9845,3483461,4,10100710,10100764,10100737,54
9846,3483461,5,6576914,6577173,6577043,259
9847,3483462,1,5333529,5333694,5333611,165
9848,3483462,1,17645144,17645238,17645191,94
9849,3483462,3,5347800,5349325,5348562,1525
9850,3483462,3,9570740,9570909,9570824,169
9851,3483462,3,16527212,16527299,16527255,87
9852,3483462,4,695984,696559,696271,575
9853,3483462,5,13638746,13638869,13638807,123
9854,3483463,1,1121361,1121519,1121440,158
9855,3483463,1,13077108,13077389,13077248,281
9856,3483463,2,608355,609295,608825,940
9857,3483463,2,9885505,9885832,9885668,327
9858,3483463,3,11272710,11273724,11273217,1014
9859,3483463,3,15640734,15640800,15640767,66
9860,3483463,4,16878040,16882206,16880123,4166
9861,3483463,5,10485819,10486602,10486210,783
9862,3483464,1,1089591,1093364,1091477,3773
9863,3483464,1,6223997,6224081,6224039,84
9864,3483464,1,17283616,17284161,17283888,545
9865,3483464,1,17294596,17295087,17294841,491
9866,3483464,2,5951310,5955460,5953385,4150
9867,3483464,2,7514185,7514254,7514219,69
9868,3483464,3,5837176,5837329,5837252,153
9869,3483464,3,9847527,9847879,9847703,352
9870,3483464,3,14751897,14751965,14751931,68
9871,3483464,3,17273003,17273247,17273125,244
9872,3483464,4,3373739,3374633,3374186,894
9873,3483464,4,4795777,4796009,4795893,232
9874,3483464,5,16611366,16611838,16611602,472
9875,3483464,5,21739997,21740222,21740109,225
9876,3483465,1,12935572,12935691,12935631,119
9877,3483465,1,28441219,28441659,28441439,440
9878,3483465,2,12388247,12390511,12389379,2264
9879,3483465,3,10077467,10078765,10078116,1298
9880,3483465,4,15976347,15976584,15976465,237
9881,3483465,5,1586918,1589617,1588267,2699
9882,3483466,1,10978212,10978328,10978270,116
9883,3483466,2,1118046,1119673,1118859,1627
9884,3483466,3,1318281,1318407,1318344,126
9885,3483466,3,9005119,9006051,9005585,932
9886,3483466,4,1440984,1441023,1441003,39
9887,3483466,5,22178685,22178791,22178738,106
9888,3483467,1,23209021,23209156,23209088,135
9889,3483467,1,30409983,30410125,30410054,142
9890,3483467,2,15526518,15527768,15527143,1250
9891,3483467,4,7367286,7369125,7368205,1839
9892,3483467,5,47202,47796,47499,594
9893,3483467,5,22314362,22314911,22314636,549
9894,3483468,1,4979083,4980034,4979558,951
9895,3483468,1,18131031,18131072,18131051,41
9896,3483468,2,495253,495652,495452,399
9897,3483468,2,2322138,2322170,2322154,32
9898,3483468,2,15728728,15729865,15729296,1137
9899,3483468,3,9594806,9594986,9594896,180
9900,3483468,3,18839288,18839322,18839305,34
9901,3483468,4,82672,83940,83306,1268
9902,3483468,5,4128216,4128808,4128512,592
9903,3483468,5,9003896,9005994,9004945,2098
9904,3483468,5,18022028,18026050,18024039,4022
9905,3483469,1,17472857,17473306,17473081,449
9906,3483469,1,26678254,26678347,26678300,93
9907,3483469,2,2273094,2273368,2273231,274
9908,3483469,2,14799634,14801991,14800812,2357
9909,3483469,3,6802629,6803173,6802901,544
9910,3483469,3,9492805,9493114,9492959,309
9911,3483469,5,6787439,6787442,6787440,3
9912,3483470,1,16006080,16006172,16006126,92
9913,3483470,2,6234513,6236750,6235631,2237
9914,3483470,2,8717367,8717731,8717549,364
9915,3483470,2,12899785,12899964,12899874,179
9916,3483470,3,16488729,16488960,16488844,231
9917,3483470,4,6544321,6544764,6544542,443
9918,3483470,4,14248809,14248876,14248842,67
9919,3483470,5,21143398,21143681,21143539,283
9920,3483470,5,22809800,22811115,22810457,1315
9921,3483471,1,7464089,7465310,7464699,1221
9922,3483471,1,24494384,24495219,24494801,835
9923,3483471,1,28622003,28624015,28623009,2012
9924,3483471,2,618345,618596,618470,251
9925,3483472,1,3973191,3973238,3973214,47
9926,3483472,1,12934791,12934923,12934857,132
9927,3483472,2,7472646,7472938,7472792,292
9928,3483472,3,9696893,9697444,9697168,551
9929,3483472,3,15997774,15997955,15997864,181
9930,3483472,4,11348583,11348697,11348640,114
9931,3483472,5,6611335,6614686,6613010,3351
9932,3483472,5,20670470,20671010,20670740,540
9933,3483473,1,26274977,26277158,26276067,2181
9934,3483473,2,6763858,6763997,6763927,139
9935,3483473,3,9161032,9161175,9161103,143
9936,3483473,4,17803945,17804404,17804174,459
9937,3483473,5,4867397,4867476,4867436,79
9938,3483473,5,16548091,16548140,16548115,49
9939,3483474,1,29266017,29266364,29266190,347
9940,3483474,2,17473329,17473716,17473522,387
9941,3483474,3,11920382,11921142,11920762,760
9942,3483474,3,22196838,22197045,22196941,207
9943,3483474,4,14626685,14626714,14626699,29
9944,3483475,2,6285105,6285365,6285235,260
9945,3483475,3,3414256,3415725,3414990,1469
9946,3483475,3,16780951,16780990,16780970,39
9947,3483475,3,21453235,21456943,21455089,3708
9948,3483475,4,7736737,7737143,7736940,406
9949,3483475,5,4405537,4405947,4405742,410
9950,3483475,5,9660095,9662433,9661264,2338
9951,3483476,1,18314637,18315262,18314949,625
9952,3483476,1,20440252,20443644,20441948,3392
9953,3483476,2,1540482,1540558,1540520,76
9954,3483476,2,18977894,18978629,18978261,735
9955,3483476,3,11740621,11740647,11740634,26
9956,3483476,4,5426674,5426694,5426684,20
9957,3483476,5,344364,344770,344567,406
9958,3483476,5,16080470,16081132,16080801,662
9959,3483476,5,25750279,25750585,25750432,306
9960,3483477,1,21224665,21225909,21225287,1244
9961,3483477,1,26136405,26136666,26136535,261
9962,3483477,2,9551987,9552295,9552141,308
9963,3483477,3,4777828,4778067,4777947,239
9964,3483477,4,7333312,7333513,7333412,201
9965,3483477,4,13122890,13125307,13124098,2417
9966,3483477,4,17363786,17365000,17364393,1214
9967,3483477,5,18876629,18877002,18876815,373
9968,3483478,1,569269,569887,569578,618
9969,3483478,1,12639349,12640299,12639824,950
9970,3483478,1,22110153,22110463,22110308,310
9971,3483478,2,10675614,10676311,10675962,697
9972,3483478,2,15152149,15152731,15152440,582
9973,3483478,3,810349,810563,810456,214
9974,3483478,3,16220398,16220867,16220632,469
9975,3483478,3,16226345,16227545,16226945,1200
9976,3483478,4,7379090,7380045,7379567,955
9977,3483478,4,10430042,10430100,10430071,58
9978,3483478,5,18775534,18778351,18776942,2817
9979,3483479,1,12584498,12584854,12584676,356
9980,3483479,1,20677756,20678791,20678273,1035
9981,3483479,3,6369792,6369852,6369822,60
9982,3483479,4,7311481,7312561,7312021,1080
9983,3483479,4,7769371,7769379,7769375,8
9984,3483479,5,7243965,7244125,7244045,160
9985,3483480,1,10635008,10635443,10635225,435
9986,3483480,2,147111,147321,147216,210
9987,3483480,3,8174679,8174775,8174727,96
9988,3483480,4,6956345,6958737,6957541,2392
9989,3483480,5,17966370,17966838,17966604,468
9990,3483481,1,4224634,4224744,4224689,110
9991,3483481,1,10048042,10048121,10048081,79
9992,3483481,1,11937526,11937569,11937547,43
9993,3483481,1,29452155,29452996,29452575,841
9994,3483481,2,5520172,5520763,5520467,591
9995,3483481,2,7739331,7740664,7739997,1333
9996,3483481,4,15406914,15407536,15407225,622
9997,3483481,5,7680453,7680713,7680583,260
9998,3483481,5,16138629,16140150,16139389,1521
9999,3483482,1,7257941,7259398,7258669,1457
10000,3483482,1,12450756,12451999,12451377,1243
10001,3483482,2,6033611,6034151,6033881,540
10002,3483482,2,18599753,18599987,18599870,234
10003,3483482,3,19573658,19574218,19573938,560
10004,3483482,4,4824194,4824576,4824385,382
10005,3483482,5,1282985,1283057,1283021,72
10006,3483482,5,15419288,15419998,15419643,710
10007,3483483,1,7084893,7086349,7085621,1456
10008,3483483,1,20400795,20403574,20402184,2779
10009,3483483,1,26647032,26647778,26647405,746
10010,3483483,2,527966,529875,528920,1909
10011,3483483,2,2181177,2181296,2181236,119
10012,3483483,2,18458710,18458995,18458852,285
10013,3483483,3,20913138,20913576,20913357,438
10014,3483483,3,21724220,21724729,21724474,509
10015,3483483,4,17798645,17799203,17798924,558
10016,3483483,5,3834877,3836395,3835636,1518
10017,3483483,5,7109164,7111616,7110390,2452
10018,3483483,5,13822087,13822111,13822099,24
10019,3483483,5,14065621,14067592,14066606,1971
10020,3483484,1,13038933,13039224,13039078,291
10021,3483484,1,27096510,27096539,27096524,29
10022,3483484,3,7620854,7622162,7621508,1308
10023,3483484,3,10803527,10803624,10803575,97
10024,3483484,4,1309320,1309390,1309355,70
10025,3483484,4,1495499,1495657,1495578,158
10026,3483484,5,1572289,1572806,1572547,517
10027,3483484,5,9875328,9877437,9876382,2109
10028,3483485,1,173162,173531,173346,369
10029,3483485,2,2324352,2324443,2324397,91
10030,3483485,2,6805079,6805346,6805212,267
10031,3483485,4,10461805,10462581,10462193,776
10032,3483485,5,16469999,16470260,16470129,261
10033,3483485,5,25771441,25771626,25771533,185
10034,3483486,1,10157549,10158195,10157872,646
10035,3483486,1,16033415,16033538,16033476,123
10036,3483486,1,27346319,27346529,27346424,210
10037,3483486,2,9735513,9735926,9735719,413
10038,3483486,3,18788464,18789568,18789016,1104
10039,3483486,5,9523751,9524406,9524078,655
10040,3483487,1,4374375,4375320,4374847,945
10041,3483487,1,12645082,12645355,12645218,273
10042,3483487,1,13898201,13898385,13898293,184
10043,3483487,1,26976622,26976654,26976638,32
10044,3483487,2,639218,639270,639244,52
10045,3483487,3,5363634,5364963,5364298,1329
10046,3483487,3,7954883,7955762,7955322,879
10047,3483487,3,16194208,16194262,16194235,54
10048,3483487,4,14976535,14976741,14976638,206
10049,3483487,5,1111443,1112051,1111747,608
10050,3483487,5,6755021,6755222,6755121,201
10051,3483487,5,17805552,17806228,17805890,676
10052,3483488,1,11390960,11391059,11391009,99
10053,3483488,1,26642866,26643120,26642993,254
10054,3483488,2,11830894,11831771,11831332,877
10055,3483488,3,6775372,6775654,6775513,282
10056,3483488,3,16036372,16036800,16036586,428
10057,3483488,5,6441211,6441359,6441285,148
10058,3483488,5,14106312,14106585,14106448,273
10059,3483488,5,20541129,20541180,20541154,51
10060,3483489,1,7786524,7787323,7786923,799
10061,3483489,1,18020339,18020443,18020391,104
10062,3483489,1,19881894,19881959,19881926,65
10063,3483489,2,6226586,6227500,6227043,914
10064,3483489,3,15867669,15867745,15867707,76
10065,3483489,3,17812756,17813660,17813208,904
10066,3483489,4,1005695,1005745,1005720,50
10067,3483489,4,7285374,7285536,7285455,162
10068,3483489,5,10927976,10928019,10927997,43
10069,3483490,1,4741697,4741972,4741834,275
10070,3483490,1,12331833,12333570,12332701,1737
10071,3483490,1,24343822,24344724,24344273,902
10072,3483490,2,9763201,9763687,9763444,486
10073,3483490,2,12962856,12963179,12963017,323
10074,3483490,4,10608566,10608614,10608590,48
10075,3483490,5,566438,568761,567599,2323
10076,3483490,5,7975999,7976244,7976121,245
10077,3483491,1,17181879,17183186,17182532,1307
10078,3483491,1,24485603,24485627,24485615,24
10079,3483491,2,473244,474952,474098,1708
10080,3483491,2,14895092,14895117,14895104,25
10081,3483491,3,16516095,16516199,16516147,104
10082,3483491,4,7243257,7243485,7243371,228
10083,3483491,4,8074792,8076059,8075425,1267
10084,3483491,5,3243126,3244755,3243940,1629
10085,3483491,5,22809260,22811115,22810187,1855
10086,3483491,5,24874264,24877444,24875854,3180
10087,3483492,1,1139955,1140588,1140271,633
10088,3483492,1,10549398,10549598,10549498,200
10089,3483492,1,20829619,20830683,20830151,1064
10090,3483492,2,7571375,7572000,7571687,625
10091,3483492,3,22813695,22813781,22813738,86
10092,3483492,4,5793003,5794456,5793729,1453
10093,3483492,4,15452477,15454438,15453457,1961
10094,3483493,1,10976438,10976454,10976446,16
10095,3483493,1,24647271,24647289,24647280,18
10096,3483493,2,6788960,6789105,6789032,145
10097,3483493,2,7216730,7216786,7216758,56
10098,3483493,2,16152976,16153917,16153446,941
10099,3483493,3,7773079,7773395,7773237,316
10100,3483493,3,17450986,17451528,17451257,542
10101,3483493,3,18809948,18811037,18810492,1089
10102,3483493,4,7369220,7369626,7369423,406
10103,3483493,5,14518634,14518948,14518791,314
10104,3483494,1,9800297,9800852,9800574,555
10105,3483494,1,10970759,10970812,10970785,53
10106,3483494,1,30266044,30266564,30266304,520
10107,3483494,2,2294726,2294951,2294838,225
10108,3483494,2,15010658,15011517,15011087,859
10109,3483494,3,17479256,17479515,17479385,259
10110,3483494,4,5427231,5427850,5427540,619
10111,3483494,4,5928621,5928808,5928714,187
10112,3483494,5,6597761,6597786,6597773,25
10113,3483494,5,10279851,10280290,10280070,439
10114,3483494,5,26250114,26250145,26250129,31
10115,3483495,1,19854241,19854477,19854359,236
10116,3483495,1,29244669,29245479,29245074,810
10117,3483495,3,1879310,1879388,1879349,78
10118,3483495,3,18595037,18595141,18595089,104
10119,3483495,4,16397057,16398874,16397965,1817
10120,3483496,1,2443268,2444859,2444063,1591
10121,3483496,1,11186904,11187794,11187349,890
10122,3483496,1,26666672,26668058,26667365,1386
10123,3483496,2,8425336,8426887,8426111,1551
10124,3483496,3,17755915,17756110,17756012,195
10125,3483496,4,12358751,12359342,12359046,591
10126,3483496,5,23692562,23692632,23692597,70
10127,3483496,5,24987759,24988474,24988116,715
10128,3483497,1,2925090,2926849,2925969,1759
10129,3483497,1,4598387,4598413,4598400,26
10130,3483497,1,23742580,23743392,23742986,812
10131,3483497,1,25953919,25955053,25954486,1134
10132,3483497,2,7837680,7837752,7837716,72
10133,3483497,2,8622381,8622522,8622451,141
10134,3483497,3,18587363,18594729,18591046,7366
10135,3483497,4,6448555,6449092,6448823,537
10136,3483497,4,6863710,6863905,6863807,195
10137,3483497,5,810956,811043,810999,87
10138,3483497,5,2412822,2414643,2413732,1821
10139,3483498,1,2889903,2892605,2891254,2702
10140,3483498,1,6930105,6934934,6932519,4829
10141,3483498,1,22591023,22591199,22591111,176
10142,3483498,2,7897295,7897539,7897417,244
10143,3483498,2,16860993,16861145,16861069,152
10144,3483498,3,5767424,5767431,5767427,7
10145,3483498,4,5724843,5724993,5724918,150
10146,3483498,4,9579497,9580659,9580078,1162
10147,3483498,5,3826469,3827584,3827026,1115
10148,3483499,1,19847962,19848667,19848314,705
10149,3483499,3,11508891,11509299,11509095,408
10150,3483499,4,6835570,6836105,6835837,535
10151,3483499,4,7436621,7436801,7436711,180
10152,3483499,5,8840535,8840940,8840737,405
10153,3483499,5,14934021,14934822,14934421,801
10154,3483500,1,2515397,2515576,2515486,179
10155,3483500,2,189739,190382,190060,643
10156,3483500,2,10058745,10058772,10058758,27
10157,3483500,2,12430932,12431040,12430986,108
10158,3483500,3,9334068,9335470,9334769,1402
10159,3483500,5,10261698,10262010,10261854,312
10160,3483500,5,18764235,18764339,18764287,104
10161,3483500,5,21127278,21127924,21127601,646
10162,3483500,5,26503898,26504091,26503994,193
10163,3483501,1,10892536,10893258,10892897,722
10164,3483501,1,15985406,15985495,15985450,89
10165,3483501,2,162552,162726,162639,174
10166,3483501,2,2212612,2212671,2212641,59
10167,3483501,2,14785400,14786995,14786197,1595
10168,3483501,3,11746769,11748041,11747405,1272
10169,3483501,4,5230175,5230311,5230243,136
10170,3483501,5,7272798,7272806,7272802,8
10171,3483502,1,3889096,3889347,3889221,251
10172,3483502,1,13144032,13144096,13144064,64
10173,3483502,1,29674517,29675715,29675116,1198
10174,3483502,3,8714713,8715443,8715078,730
10175,3483502,4,6359252,6359299,6359275,47
10176,3483502,4,16371878,16373223,16372550,1345
10177,3483502,5,5743259,5743325,5743292,66
10178,3483502,5,14908252,14908336,14908294,84
10179,3483503,1,4472083,4472098,4472090,15
10180,3483503,2,11392703,11396779,11394741,4076
10181,3483503,2,17416344,17417933,17417138,1589
10182,3483503,3,20890003,20891664,20890833,1661
10183,3483503,4,1191228,1191469,1191348,241
10184,3483503,5,9353335,9355769,9354552,2434
10185,3483503,5,19442067,19442757,19442412,690
10186,3483504,1,8401414,8401476,8401445,62
10187,3483504,1,22152072,22152394,22152233,322
10188,3483504,1,24689666,24689720,24689693,54
10189,3483504,2,5514001,5514006,5514003,5
10190,3483504,2,7376330,7376642,7376486,312
10191,3483504,2,16498784,16499247,16499015,463
10192,3483504,3,2151477,2152052,2151764,575
10193,3483504,4,5735405,5737163,5736284,1758
10194,3483504,4,14972206,14972631,14972418,425
10195,3483504,5,22359601,22359812,22359706,211
10196,3483505,1,2278919,2278961,2278940,42
10197,3483505,1,13897294,13898003,13897648,709
10198,3483505,2,2268581,2269003,2268792,422
10199,3483505,3,9761448,9761497,9761472,49
10200,3483505,3,11162869,11163448,11163158,579
10201,3483505,5,13750276,13750806,13750541,530
10202,3483505,5,21321023,21322274,21321648,1251
10203,3483506,1,16771613,16772151,16771882,538
10204,3483506,1,24656316,24656351,24656333,35
10205,3483506,1,26157028,26157158,26157093,130
10206,3483506,2,7030680,7030827,7030753,147
10207,3483506,2,9229934,9230022,9229978,88
10208,3483506,3,6253398,6253691,6253544,293
10209,3483506,3,11382618,11382733,11382675,115
10210,3483506,3,21913628,21914594,21914111,966
10211,3483506,4,522448,522754,522601,306
10212,3483506,4,7687604,7687677,7687640,73
10213,3483506,4,18118561,18118579,18118570,18
10214,3483506,5,4115552,4116142,4115847,590
10215,3483507,1,10295819,10296235,10296027,416
10216,3483507,1,25402499,25403659,25403079,1160
10217,3483507,2,12134187,12135002,12134594,815
10218,3483507,3,17896897,17897101,17896999,204
10219,3483507,5,19368281,19368754,19368517,473
10220,3483508,1,24886587,24889952,24888269,3365
10221,3483508,2,2288610,2289037,2288823,427
10222,3483508,4,7715529,7715645,7715587,116
10223,3483508,5,21973395,21973716,21973555,321
10224,3483509,1,7152769,7152853,7152811,84
10225,3483509,2,12938902,12939324,12939113,422
10226,3483509,3,3804993,3805579,3805286,586
10227,3483509,4,525344,525465,525404,121
10228,3483509,4,7705266,7706211,7705738,945
10229,3483509,4,18172810,18173133,18172971,323
10230,3483510,1,7733272,7734101,7733686,829
10231,3483510,2,503925,503986,503955,61
10232,3483510,2,6354683,6355566,6355124,883
10233,3483510,3,610091,610401,610246,310
10234,3483510,4,5849120,5849288,5849204,168
10235,3483510,5,6102736,6103342,6103039,606
10236,3483510,5,8359840,8360127,8359983,287
10237,3483510,5,22510883,22513967,22512425,3084
10238,3483511,1,26285001,26285155,26285078,154
10239,3483511,2,6597506,6609006,6603256,11500
10240,3483511,3,166078,166464,166271,386
10241,3483511,3,1940540,1940598,1940569,58
10242,3483511,3,3310638,3313225,3311931,2587
10243,3483511,3,11617171,11617186,11617178,15
10244,3483511,4,737506,739223,738364,1717
10245,3483511,5,21803351,21803587,21803469,236
10246,3483512,1,23433108,23433133,23433120,25
10247,3483512,1,28482677,28486451,28484564,3774
10248,3483512,3,18570704,18572456,18571580,1752
10249,3483512,5,918885,919743,919314,858
10250,3483513,1,10622229,10623329,10622779,1100
10251,3483513,1,12869040,12869622,12869331,582
10252,3483513,1,24996063,24996345,24996204,282
10253,3483513,1,25735095,25739535,25737315,4440
10254,3483513,3,1157317,1158720,1158018,1403
10255,3483513,4,9811524,9811840,9811682,316
10256,3483513,5,3539007,3540015,3539511,1008
10257,3483513,5,17315451,17315452,17315451,1
10258,3483514,1,24886070,24886587,24886328,517
10259,3483514,2,2269795,2270690,2270242,895
10260,3483514,4,7712697,7712778,7712737,81
10261,3483514,5,21972240,21973716,21972978,1476
10262,3483515,1,17716816,17717459,17717137,643
10263,3483515,2,10642548,10642590,10642569,42
10264,3483515,3,8606433,8607879,8607156,1446
10265,3483515,3,17918893,17919374,17919133,481
10266,3483515,4,17694271,17695595,17694933,1324
10267,3483515,5,2695019,2695950,2695484,931
10268,3483515,5,8236811,8238727,8237769,1916
10269,3483516,1,7850731,7853344,7852037,2613
10270,3483516,1,29226878,29227949,29227413,1071
10271,3483516,2,18693858,18695176,18694517,1318
10272,3483516,3,10874159,10874216,10874187,57
10273,3483516,3,18199477,18199754,18199615,277
10274,3483516,3,19696910,19698411,19697660,1501
10275,3483516,4,11345104,11345163,11345133,59
10276,3483516,5,20041438,20041940,20041689,502
10277,3483517,1,8923168,8923284,8923226,116
10278,3483517,1,12058698,12061061,12059879,2363
10279,3483517,1,28630836,28630915,28630875,79
10280,3483517,2,5937573,5939063,5938318,1490
10281,3483517,2,10856894,10857222,10857058,328
10282,3483517,3,3648864,3649380,3649122,516
10283,3483517,3,8264270,8264598,8264434,328
10284,3483517,3,16238459,16238796,16238627,337
10285,3483517,4,5710390,5710434,5710412,44
10286,3483517,4,8320510,8320643,8320576,133
10287,3483518,1,440564,445271,442917,4707
10288,3483518,1,16127975,16128294,16128134,319
10289,3483518,1,24406570,24406742,24406656,172
10290,3483518,2,18339286,18340686,18339986,1400
10291,3483518,3,7120829,7120936,7120882,107
10292,3483518,4,18036309,18037342,18036825,1033
10293,3483518,5,9023856,9024322,9024089,466
10294,3483519,1,6577984,6578226,6578105,242
10295,3483519,1,13467782,13467825,13467803,43
10296,3483519,3,10787320,10790271,10788795,2951
10297,3483519,4,5365004,5365831,5365417,827
10298,3483519,5,1607219,1607477,1607348,258
10299,3483520,1,10618350,10618597,10618473,247
10300,3483520,1,27136812,27137072,27136942,260
10301,3483520,2,6274840,6276427,6275633,1587
10302,3483520,2,6777565,6777769,6777667,204
10303,3483520,3,3399213,3399880,3399546,667
10304,3483520,3,9047604,9048205,9047904,601
10305,3483520,4,7657355,7657968,7657661,613
10306,3483520,5,3479113,3480602,3479857,1489
10307,3483520,5,9150509,9151712,9151110,1203
10308,3483520,5,21802792,21803107,21802949,315
10309,3483521,1,8178740,8178861,8178800,121
10310,3483521,2,10187781,10188429,10188105,648
10311,3483521,3,5311412,5311551,5311481,139
10312,3483521,3,16678424,16678533,16678478,109
10313,3483521,4,7783183,7783193,7783188,10
10314,3483521,4,10356348,10356398,10356373,50
10315,3483521,4,16692240,16692333,16692286,93
10316,3483521,5,7182224,7182655,7182439,431
10317,3483521,5,13880527,13880739,13880633,212
10318,3483522,1,22395148,22396501,22395824,1353
10319,3483522,2,5538735,5538848,5538791,113
10320,3483522,2,16447011,16447336,16447173,325
10321,3483522,3,8903763,8904010,8903886,247
10322,3483522,3,22940916,22940974,22940945,58
10323,3483522,4,7931881,7931942,7931911,61
10324,3483522,4,18055606,18056908,18056257,1302
10325,3483522,5,15749648,15750467,15750057,819
10326,3483522,5,16212255,16212294,16212274,39
10327,3483522,5,26503232,26503296,26503264,64
10328,3483523,1,19097953,19098786,19098369,833
10329,3483523,1,26799296,26800457,26799876,1161
10330,3483523,3,10126811,10126944,10126877,133
10331,3483523,4,736827,739223,738025,2396
10332,3483523,4,6897949,6897964,6897956,15
10333,3483523,4,10775640,10776156,10775898,516
10334,3483523,5,1483692,1484228,1483960,536
10335,3483523,5,24771105,24771281,24771193,176
10336,3483524,1,4290739,4290873,4290806,134
10337,3483524,1,20410678,20411025,20410851,347
10338,3483524,2,4829077,4829208,4829142,131
10339,3483524,3,580866,580899,580882,33
10340,3483524,3,10415922,10416647,10416284,725
10341,3483524,3,17690261,17690671,17690466,410
10342,3483524,3,19913014,19913438,19913226,424
10343,3483524,4,12399259,12399570,12399414,311
10344,3483524,5,6233304,6233517,6233410,213
10345,3483524,5,18482197,18482232,18482214,35
10346,3483524,5,25499491,25499528,25499509,37
10347,3483525,1,629134,631363,630248,2229
10348,3483525,1,11473053,11474185,11473619,1132
10349,3483525,1,23277974,23279391,23278682,1417
10350,3483525,2,17665296,17667049,17666172,1753
10351,3483525,3,11867651,11868464,11868057,813
10352,3483525,4,8420268,8423642,8421955,3374
10353,3483525,5,25460789,25461039,25460914,250
10354,3483526,1,10555725,10556242,10555983,517
10355,3483526,1,25301402,25302310,25301856,908
10356,3483526,1,26426717,26426838,26426777,121
10357,3483526,2,9673417,9673651,9673534,234
10358,3483526,3,6417540,6417911,6417725,371
10359,3483526,4,8606624,8608007,8607315,1383
10360,3483526,5,9955625,9955695,9955660,70
10361,3483526,5,26230955,26231915,26231435,960
10362,3483527,1,8071096,8071411,8071253,315
10363,3483527,1,29735308,29735633,29735470,325
10364,3483527,2,6354107,6354494,6354300,387
10365,3483527,3,10179699,10179737,10179718,38
10366,3483527,3,11105559,11105605,11105582,46
10367,3483527,4,5738920,5739124,5739022,204
10368,3483528,1,11828258,11829589,11828923,1331
10369,3483528,1,16775343,16775611,16775477,268
10370,3483528,1,29482447,29482735,29482591,288
10371,3483528,2,17436561,17436940,17436750,379
10372,3483528,3,15641901,15642062,15641981,161
10373,3483528,4,129094,130278,129686,1184
10374,3483528,5,807755,808690,808222,935
10375,3483528,5,1965662,1966032,1965847,370
10376,3483528,5,13614904,13614971,13614937,67
10377,3483528,5,15934334,15934400,15934367,66
10378,3483528,5,21272106,21272232,21272169,126
10379,3483529,1,8344637,8344919,8344778,282
10380,3483529,1,13451741,13452171,13451956,430
10381,3483529,1,24656316,24656351,24656333,35
10382,3483529,2,7717661,7717811,7717736,150
10383,3483529,2,9601674,9602207,9601940,533
10384,3483529,2,17118171,17118282,17118226,111
10385,3483529,3,10647492,10647625,10647558,133
10386,3483529,3,16371912,16371945,16371928,33
10387,3483529,4,1328977,1331115,1330046,2138
10388,3483529,5,24966595,24966731,24966663,136
10389,3483530,2,9150643,9150983,9150813,340
10390,3483530,2,15144878,15145197,15145037,319
10391,3483530,3,15839613,15839907,15839760,294
10392,3483531,1,4066936,4067079,4067007,143
10393,3483531,1,11942952,11944269,11943610,1317
10394,3483531,1,17870756,17871209,17870982,453
10395,3483531,1,20558945,20561483,20560214,2538
10396,3483531,3,1497720,1498599,1498159,879
10397,3483531,5,8529011,8529204,8529107,193
10398,3483531,5,14241769,14241777,14241773,8
10399,3483532,1,22249276,22249383,22249329,107
10400,3483532,2,2273094,2273368,2273231,274
10401,3483532,2,7179321,7179434,7179377,113
10402,3483532,2,14973212,14973292,14973252,80
10403,3483532,3,3533846,3534176,3534011,330
10404,3483532,3,17726672,17726786,17726729,114
10405,3483532,4,729611,731447,730529,1836
10406,3483532,5,6448420,6451444,6449932,3024
10407,3483533,1,2366666,2367720,2367193,1054
10408,3483533,1,8281296,8281303,8281299,7
10409,3483533,2,10071026,10072116,10071571,1090
10410,3483533,2,16164119,16164406,16164262,287
10411,3483533,3,5424189,5424359,5424274,170
10412,3483533,3,17537964,17539328,17538646,1364
10413,3483533,3,21903077,21904290,21903683,1213
10414,3483533,4,13588247,13588424,13588335,177
10415,3483533,5,5886484,5887605,5887044,1121
10416,3483533,5,7325209,7325675,7325442,466
10417,3483533,5,25094556,25094568,25094562,12
10418,3483534,1,25660901,25663015,25661958,2114
10419,3483534,3,11111341,11112470,11111905,1129
10420,3483534,4,10951983,10953738,10952860,1755
10421,3483534,4,17310524,17313542,17312033,3018
10422,3483534,5,3494019,3495088,3494553,1069
10423,3483534,5,25993429,25993586,25993507,157
10424,3483535,1,6468726,6469262,6468994,536
10425,3483535,2,2086706,2089521,2088113,2815
10426,3483535,2,15952042,15952371,15952206,329
10427,3483535,3,3310638,3313225,3311931,2587
10428,3483535,4,658198,660712,659455,2514
10429,3483535,4,12308422,12309255,12308838,833
10430,3483535,5,2964775,2965886,2965330,1111
10431,3483536,1,25950651,25950705,25950678,54
10432,3483536,3,2891878,2892154,2892016,276
10433,3483536,5,6277869,6279838,6278853,1969
10434,3483536,5,14897033,14898041,14897537,1008
10435,3483536,5,25426386,25426948,25426667,562
10436,3483536,5,26586499,26587116,26586807,617
10437,3483537,1,594166,594446,594306,280
10438,3483537,1,11119415,11120082,11119748,667
10439,3483537,1,11620629,11620737,11620683,108
10440,3483537,2,8329082,8329331,8329206,249
10441,3483537,3,6463928,6464345,6464136,417
10442,3483537,3,18299784,18300617,18300200,833
10443,3483537,3,20685414,20687469,20686441,2055
10444,3483537,4,1211036,1211231,1211133,195
10445,3483537,4,5284906,5285067,5284986,161
10446,3483537,4,18187986,18188070,18188028,84
10447,3483537,5,7085123,7085587,7085355,464
10448,3483538,2,348029,348823,348426,794
10449,3483538,3,17553806,17554186,17553996,380
10450,3483538,4,179908,180064,179986,156
10451,3483538,4,7634372,7635543,7634957,1171
10452,3483538,4,11376845,11376940,11376892,95
10453,3483538,5,18706367,18707415,18706891,1048
10454,3483539,2,7418953,7420612,7419782,1659
10455,3483539,2,12080578,12083344,12081961,2766
10456,3483539,2,18678916,18679620,18679268,704
10457,3483539,3,8240716,8240796,8240756,80
10458,3483539,5,576458,576612,576535,154
10459,3483540,1,6270318,6271251,6270784,933
10460,3483540,1,10305386,10305484,10305435,98
10461,3483540,1,23164333,23164591,23164462,258
10462,3483540,1,27113333,27113571,27113452,238
10463,3483540,3,11214105,11214401,11214253,296
10464,3483540,4,5168555,5168632,5168593,77
10465,3483540,4,16687124,16687587,16687355,463
10466,3483540,5,9139735,9139753,9139744,18
10467,3483540,5,16035253,16035368,16035310,115
10468,3483540,5,19838285,19838311,19838298,26
10469,3483541,1,11630388,11631118,11630753,730
10470,3483541,1,25236380,25236674,25236527,294
10471,3483541,1,25667898,25671190,25669544,3292
10472,3483541,2,5055461,5055615,5055538,154
10473,3483541,2,10802070,10802102,10802086,32
10474,3483541,3,9458943,9459360,9459151,417
10475,3483541,3,18300614,18300617,18300615,3
10476,3483541,5,6220683,6220779,6220731,96
10477,3483541,5,13334482,13336992,13335737,2510
10478,3483542,1,7471447,7471880,7471663,433
10479,3483542,1,7694873,7695473,7695173,600
10480,3483542,1,23440435,23440622,23440528,187
10481,3483542,2,11970304,11971374,11970839,1070
10482,3483542,2,12795179,12795205,12795192,26
10483,3483542,3,7693792,7693826,7693809,34
10484,3483542,3,9281615,9282025,9281820,410
10485,3483542,4,10723603,10723721,10723662,118
10486,3483542,4,18051024,18051862,18051443,838
10487,3483543,2,349877,351126,350501,1249
10488,3483543,2,12998135,12998337,12998236,202
10489,3483543,3,2542530,2543384,2542957,854
10490,3483543,3,8941757,8941940,8941848,183
10491,3483543,4,1051870,1052072,1051971,202
10492,3483543,4,18136675,18137089,18136882,414
10493,3483543,5,13820286,13820335,13820310,49
10494,3483544,1,13118676,13118709,13118692,33
10495,3483544,1,28564530,28564796,28564663,266
10496,3483544,3,17473610,17473904,17473757,294
10497,3483544,3,18357481,18357513,18357497,32
10498,3483544,4,11737157,11737216,11737186,59
10499,3483544,5,15826339,15826443,15826391,104
10500,3483545,1,484137,484340,484238,203
10501,3483545,1,25223023,25223435,25223229,412
10502,3483545,1,27853564,27856120,27854842,2556
10503,3483545,3,17448450,17448502,17448476,52
10504,3483545,5,5274669,5275936,5275302,1267
10505,3483545,5,10482338,10482488,10482413,150
10506,3483546,1,6472913,6474055,6473484,1142
10507,3483546,1,20159040,20159710,20159375,670
10508,3483546,1,28631772,28632788,28632280,1016
10509,3483546,2,17471736,17472127,17471931,391
10510,3483546,3,16706523,16706553,16706538,30
10511,3483546,4,5240197,5240515,5240356,318
10512,3483546,5,7540912,7542842,7541877,1930
10513,3483546,5,7755311,7757958,7756634,2647
10514,3483546,5,13661135,13661775,13661455,640
10515,3483546,5,26247606,26248177,26247891,571
10516,3483547,1,19712735,19713040,19712887,305
10517,3483547,1,26898649,26900548,26899598,1899
10518,3483547,3,4637342,4637577,4637459,235
10519,3483547,5,17036285,17036654,17036469,369
10520,3483548,1,15985406,15985495,15985450,89
10521,3483548,2,5946385,5946406,5946395,21
10522,3483548,2,16695855,16696118,16695986,263
10523,3483548,3,5499933,5499969,5499951,36
10524,3483548,3,18057765,18058537,18058151,772
10525,3483548,4,6171194,6171224,6171209,30
10526,3483548,5,5819029,5819450,5819239,421
10527,3483548,5,14091838,14092205,14092021,367
10528,3483548,5,24976977,24977723,24977350,746
10529,3483549,1,23808038,23808239,23808138,201
10530,3483549,2,10125781,10127363,10126572,1582
10531,3483549,3,17587745,17587753,17587749,8
10532,3483549,4,320507,322181,321344,1674
10533,3483549,5,9255995,9256718,9256356,723
10534,3483549,5,19445746,19447361,19446553,1615
10535,3483549,5,21604095,21605094,21604594,999
10536,3483550,3,17168392,17169386,17168889,994
10537,3483550,4,744173,746534,745353,2361
10538,3483550,4,16269774,16270061,16269917,287
10539,3483550,5,944408,944634,944521,226
10540,3483550,5,5713865,5714252,5714058,387
10541,3483550,5,15316304,15316682,15316493,378
10542,3483550,5,25129844,25131001,25130422,1157
10543,3483551,1,6905943,6906116,6906029,173
10544,3483551,1,18373892,18373894,18373893,2
10545,3483551,1,25663562,25663625,25663593,63
10546,3483551,2,83573,83764,83668,191
10547,3483551,2,7413329,7413676,7413502,347
10548,3483551,3,11275970,11276751,11276360,781
10549,3483551,4,8405734,8406044,8405889,310
10550,3483551,4,16510675,16512756,16511715,2081
10551,3483551,5,3695805,3697154,3696479,1349
10552,3483551,5,21628457,21628713,21628585,256
10553,3483552,1,9459985,9461415,9460700,1430
10554,3483552,1,19685182,19685636,19685409,454
10555,3483552,2,6777065,6777531,6777298,466
10556,3483552,2,8094542,8094679,8094610,137
10557,3483552,2,9788595,9790369,9789482,1774
10558,3483552,2,14155308,14155361,14155334,53
10559,3483552,3,11104380,11104496,11104438,116
10560,3483552,4,30563,30569,30566,6
10561,3483552,4,8566603,8570569,8568586,3966
10562,3483552,5,5363372,5363493,5363432,121
10563,3483552,5,18517542,18517848,18517695,306
10564,3483553,1,2352440,2352728,2352584,288
10565,3483553,1,3181594,3182859,3182226,1265
10566,3483553,1,23348944,23349024,23348984,80
10567,3483553,2,15792114,15792197,15792155,83
10568,3483553,2,17757071,17758850,17757960,1779
10569,3483553,3,10112720,10114896,10113808,2176
10570,3483553,4,16830482,16831613,16831047,1131
10571,3483553,5,18722262,18722531,18722396,269
10572,3483554,1,3704852,3705260,3705056,408
10573,3483554,1,13108725,13110292,13109508,1567
10574,3483554,2,2182064,2182775,2182419,711
10575,3483554,2,10174858,10175398,10175128,540
10576,3483554,3,8027340,8028029,8027684,689
10577,3483554,3,16815145,16815317,16815231,172
10578,3483554,4,10107704,10108096,10107900,392
10579,3483554,4,17628544,17629291,17628917,747
10580,3483554,5,253078,255464,254271,2386
10581,3483554,5,778691,778945,778818,254
10582,3483554,5,21736662,21738838,21737750,2176
10583,3483555,1,5423997,5424091,5424044,94
10584,3483555,1,10684451,10684640,10684545,189
10585,3483555,1,20496195,20504185,20500190,7990
10586,3483555,1,29005944,29006174,29006059,230
10587,3483555,2,11652897,11654566,11653731,1669
10588,3483555,3,7903521,7904600,7904060,1079
10589,3483555,3,10759626,10759965,10759795,339
10590,3483555,3,16153952,16154010,16153981,58
10591,3483555,4,5464795,5464850,5464822,55
10592,3483555,4,14976535,14976741,14976638,206
10593,3483555,5,3210186,3210679,3210432,493
10594,3483555,5,9852580,9852803,9852691,223
10595,3483556,1,6269656,6270165,6269910,509
10596,3483556,1,12593884,12594751,12594317,867
10597,3483556,2,11086280,11087047,11086663,767
10598,3483556,3,1067376,1069706,1068541,2330
10599,3483556,3,9846066,9847527,9846796,1461
10600,3483556,5,13662520,13663796,13663158,1276
10601,3483556,5,24787973,24788110,24788041,137
10602,3483557,1,2460950,2462206,2461578,1256
10603,3483557,1,6917723,6918110,6917916,387
10604,3483557,1,10970759,10971013,10970886,254
10605,3483557,1,23037640,23038552,23038096,912
10606,3483557,3,10126811,10126944,10126877,133
10607,3483557,3,12761067,12761141,12761104,74
10608,3483557,4,17595907,17595928,17595917,21
10609,3483558,1,6511016,6511114,6511065,98
10610,3483558,2,483330,484028,483679,698
10611,3483558,3,8926003,8926127,8926065,124
10612,3483558,4,6357527,6358289,6357908,762
10613,3483558,4,11875874,11876053,11875963,179
10614,3483558,5,13354881,13357479,13356180,2598
10615,3483559,1,779397,783309,781353,3912
10616,3483559,1,24410801,24412220,24411510,1419
10617,3483559,2,10812956,10813812,10813384,856
10618,3483559,3,8620863,8620870,8620866,7
10619,3483559,5,4006387,4006414,4006400,27
10620,3483559,5,23093752,23093764,23093758,12
10621,3483559,5,25656450,25656566,25656508,116
10622,3483560,1,16642886,16642983,16642934,97
10623,3483560,1,18342618,18344449,18343533,1831
10624,3483560,2,15839485,15840713,15840099,1228
10625,3483560,3,15707245,15707253,15707249,8
10626,3483560,5,541756,544105,542930,2349
10627,3483560,5,18908472,18908571,18908521,99
10628,3483561,1,3912288,3914705,3913496,2417
10629,3483561,1,23701793,23703555,23702674,1762
10630,3483561,2,8729077,8729392,8729234,315
10631,3483561,2,18034211,18034341,18034276,130
10632,3483561,3,11746300,11746371,11746335,71
10633,3483561,3,21085067,21085851,21085459,784
10634,3483561,4,10874815,10874913,10874864,98
10635,3483561,5,6830571,6830772,6830671,201
10636,3483562,1,7942043,7944496,7943269,2453
10637,3483562,1,17283163,17283282,17283222,119
10638,3483562,2,16491208,16491574,16491391,366
10639,3483562,3,2532784,2533934,2533359,1150
10640,3483562,3,6166092,6166198,6166145,106
10641,3483562,4,10021077,10021282,10021179,205
10642,3483562,5,3465069,3465242,3465155,173
10643,3483562,5,13559417,13559951,13559684,534
10644,3483562,5,17878081,17878398,17878239,317
10645,3483563,1,6081825,6082186,6082005,361
10646,3483563,2,1343238,1344472,1343855,1234
10647,3483563,2,1344472,1344712,1344592,240
10648,3483563,2,8048197,8048864,8048530,667
10649,3483563,4,11832740,11832748,11832744,8
10650,3483564,1,8167473,8167867,8167670,394
10651,3483564,1,11184893,11185014,11184953,121
10652,3483564,2,8990609,8990809,8990709,200
10653,3483564,2,9870535,9870760,9870647,225
10654,3483564,3,15778933,15781462,15780197,2529
10655,3483564,4,12445286,12448855,12447070,3569
10656,3483564,4,15483555,15483614,15483584,59
10657,3483564,5,5048771,5048958,5048864,187
10658,3483564,5,16265201,16266188,16265694,987
10659,3483564,5,23756253,23756481,23756367,228
10660,3483565,1,12172025,12172422,12172223,397
10661,3483565,1,20786201,20786209,20786205,8
10662,3483565,2,6272999,6273312,6273155,313
10663,3483565,2,12627525,12627830,12627677,305
10664,3483565,3,18017333,18018032,18017682,699
10665,3483565,5,16850603,16850726,16850664,123
10666,3483566,1,17181273,17181284,17181278,11
10667,3483566,2,593951,594060,594005,109
10668,3483566,3,3600320,3600610,3600465,290
10669,3483566,3,8546753,8547217,8546985,464
10670,3483566,5,19538367,19538929,19538648,562
10671,3483567,1,11194519,11194773,11194646,254
10672,3483567,1,16130498,16131113,16130805,615
10673,3483567,1,24731780,24732564,24732172,784
10674,3483567,1,30414864,30415213,30415038,349
10675,3483567,2,83347,83447,83397,100
10676,3483567,2,7376330,7376642,7376486,312
10677,3483567,3,8969188,8972851,8971019,3663
10678,3483567,3,17692123,17692524,17692323,401
10679,3483567,4,10133142,10133198,10133170,56
10680,3483567,5,9795082,9795237,9795159,155
10681,3483567,5,13935076,13935679,13935377,603
10682,3483568,1,7692409,7693014,7692711,605
10683,3483568,1,22117778,22117847,22117812,69
10684,3483568,1,28508489,28511467,28509978,2978
10685,3483568,2,16407851,16409678,16408764,1827
10686,3483568,3,1177533,1178015,1177774,482
10687,3483568,4,5426489,5426558,5426523,69
10688,3483568,4,17678216,17679721,17678968,1505
10689,3483568,5,22177356,22177853,22177604,497
10690,3483569,2,618345,618596,618470,251
10691,3483569,2,18322631,18322654,18322642,23
10692,3483569,3,6792645,6793203,6792924,558
10693,3483569,3,23067809,23068862,23068335,1053
10694,3483569,4,927805,928105,927955,300
10695,3483569,5,7847023,7847201,7847112,178
10696,3483569,5,9298879,9299099,9298989,220
10697,3483569,5,18976332,18976436,18976384,104
10698,3483570,1,6702116,6702300,6702208,184
10699,3483570,1,12488202,12488470,12488336,268
10700,3483570,2,14601134,14601952,14601543,818
10701,3483570,3,21296152,21297646,21296899,1494
10702,3483570,4,7783474,7785146,7784310,1672
10703,3483570,5,9620215,9620515,9620365,300
10704,3483570,5,20916797,20916877,20916837,80
10705,3483571,1,5649599,5651476,5650537,1877
10706,3483571,1,7916602,7916927,7916764,325
10707,3483571,2,232085,232545,232315,460
10708,3483571,2,9557342,9557435,9557388,93
10709,3483571,2,11510677,11511281,11510979,604
10710,3483571,3,9024314,9024431,9024372,117
10711,3483571,3,10826711,10826775,10826743,64
10712,3483571,3,22938252,22938325,22938288,73
10713,3483571,4,16519971,16523004,16521487,3033
10714,3483571,5,8596107,8596248,8596177,141
10715,3483571,5,15033558,15033741,15033649,183
10716,3483571,5,26752253,26752268,26752260,15
10717,3483572,1,21720984,21721436,21721210,452
10718,3483572,1,22787090,22787442,22787266,352
10719,3483572,4,7169454,7169554,7169504,100
10720,3483572,4,15170120,15172924,15171522,2804
10721,3483572,5,1270668,1270877,1270772,209
10722,3483572,5,16643850,16644193,16644021,343
10723,3483573,1,18784816,18785439,18785127,623
10724,3483573,1,25877274,25877593,25877433,319
10725,3483573,2,11936363,11937934,11937148,1571
10726,3483573,3,9930903,9931877,9931390,974
10727,3483573,4,5321138,5322421,5321779,1283
10728,3483573,4,13754855,13764990,13759922,10135
10729,3483573,5,7387125,7387339,7387232,214
10730,3483573,5,15193976,15198099,15196037,4123
10731,3483574,1,4224588,4224744,4224666,156
10732,3483574,1,29182881,29183103,29182992,222
10733,3483574,2,440010,440361,440185,351
10734,3483574,2,13951459,13953065,13952262,1606
10735,3483574,3,1449369,1449505,1449437,136
10736,3483574,3,9129458,9129511,9129484,53
10737,3483574,5,386586,390743,388664,4157
10738,3483574,5,9278060,9278608,9278334,548
10739,3483574,5,22174855,22174865,22174860,10
10740,3483575,2,17687971,17688958,17688464,987
10741,3483575,3,11052970,11053051,11053010,81
10742,3483575,3,17544937,17545431,17545184,494
10743,3483575,4,493587,494545,494066,958
10744,3483576,1,17378647,17380083,17379365,1436
10745,3483576,3,7754506,7754623,7754564,117
10746,3483576,3,9339071,9339166,9339118,95
10747,3483576,3,22210615,22211108,22210861,493
10748,3483576,4,7369220,7369626,7369423,406
10749,3483576,5,6378518,6378596,6378557,78
10750,3483576,5,7978087,7978365,7978226,278
10751,3483576,5,23156634,23158346,23157490,1712
10752,3483577,1,9795318,9796679,9795998,1361
10753,3483577,1,18364180,18364561,18364370,381
10754,3483577,2,83347,83447,83397,100
10755,3483577,2,13875833,13876890,13876361,1057
10756,3483577,3,3083462,3084711,3084086,1249
10757,3483577,3,16567065,16567174,16567119,109
10758,3483577,4,6255725,6255880,6255802,155
10759,3483577,4,10128813,10129746,10129279,933
10760,3483577,5,859838,861381,860609,1543
10761,3483577,5,14933595,14933616,14933605,21
10762,3483577,5,15447233,15447363,15447298,130
10763,3483578,1,20411025,20414537,20412781,3512
10764,3483578,3,9034261,9034792,9034526,531
10765,3483578,3,15179004,15179177,15179090,173
10766,3483578,4,560492,560572,560532,80
10767,3483578,5,1268584,1268651,1268617,67
10768,3483578,5,18803509,18805109,18804309,1600
10769,3483579,1,5506421,5506545,5506483,124
10770,3483579,1,11821415,11822267,11821841,852
10771,3483579,1,17096455,17096676,17096565,221
10772,3483579,2,13000739,13000768,13000753,29
10773,3483579,3,2207658,2207838,2207748,180
10774,3483579,3,17213281,17213346,17213313,65
10775,3483579,3,21157877,21158211,21158044,334
10776,3483579,4,640873,641363,641118,490
10777,3483579,4,1335700,1336188,1335944,488
10778,3483579,4,11171630,11172060,11171845,430
10779,3483580,1,19810704,19810715,19810709,11
10780,3483580,2,2929769,2930250,2930009,481
10781,3483580,2,6016827,6016840,6016833,13
10782,3483580,3,11239625,11240810,11240217,1185
10783,3483580,4,192953,194455,193704,1502
10784,3483580,4,6332702,6333385,6333043,683
10785,3483580,5,15102363,15102419,15102391,56
10786,3483581,1,13043025,13043194,13043109,169
10787,3483581,1,23898794,23899002,23898898,208
10788,3483581,2,4806034,4806168,4806101,134
10789,3483581,3,11812747,11813100,11812923,353
10790,3483581,4,6973439,6973531,6973485,92
10791,3483581,4,9329501,9329589,9329545,88
10792,3483581,4,17398846,17399198,17399022,352
10793,3483582,1,1067878,1071783,1069830,3905
10794,3483582,2,6794131,6795275,6794703,1144
10795,3483582,3,1740506,1740755,1740630,249
10796,3483582,4,9740428,9740498,9740463,70
10797,3483582,5,577026,577714,577370,688
10798,3483582,5,16966638,16967002,16966820,364
10799,3483583,1,577323,577628,577475,305
10800,3483583,1,9308755,9309865,9309310,1110
10801,3483583,1,26580867,26581582,26581224,715
10802,3483583,2,7004562,7004826,7004694,264
10803,3483583,3,4940915,4941639,4941277,724
10804,3483583,3,12100791,12100806,12100798,15
10805,3483583,4,201471,201567,201519,96
10806,3483583,4,17708995,17710783,17709889,1788
10807,3483583,5,340618,344770,342694,4152
10808,3483583,5,16797053,16797332,16797192,279
10809,3483583,5,17111967,17112203,17112085,236
10810,3483584,1,11350855,11350911,11350883,56
10811,3483584,2,16755545,16756107,16755826,562
10812,3483584,3,7216366,7216968,7216667,602
10813,3483584,3,10358432,10358453,10358442,21
10814,3483584,3,12100842,12100886,12100864,44
10815,3483584,3,20871915,20873086,20872500,1171
10816,3483584,4,846856,847871,847363,1015
10817,3483584,4,6440313,6440766,6440539,453
10818,3483584,5,7794210,7795085,7794647,875
10819,3483584,5,21505586,21506159,21505872,573
10820,3483585,1,7629433,7631477,7630455,2044
10821,3483585,1,9882311,9882382,9882346,71
10822,3483585,2,6692886,6692985,6692935,99
10823,3483585,2,10794804,10795050,10794927,246
10824,3483585,3,6347329,6347400,6347364,71
10825,3483585,3,9490350,9490531,9490440,181
10826,3483585,3,11775308,11775341,11775324,33
10827,3483585,5,15322442,15322490,15322466,48
10828,3483585,5,16392866,16393485,16393175,619
10829,3483586,1,28259916,28260141,28260028,225
10830,3483586,3,884989,885164,885076,175
10831,3483586,3,10631890,10632082,10631986,192
10832,3483586,4,9317956,9317980,9317968,24
10833,3483586,5,3307728,3308344,3308036,616
10834,3483586,5,26307361,26310090,26308725,2729
10835,3483586,5,26793268,26794126,26793697,858
10836,3483587,2,1358652,1359473,1359062,821
10837,3483587,4,7718601,7718892,7718746,291
10838,3483587,5,9847159,9847554,9847356,395
10839,3483587,5,19847395,19847586,19847490,191
10840,3483588,1,16134867,16135258,16135062,391
10841,3483588,1,23461464,23461757,23461610,293
10842,3483588,3,3581715,3581855,3581785,140
10843,3483588,3,3690908,3692141,3691524,1233
10844,3483588,4,479462,479773,479617,311
10845,3483588,4,10687593,10687766,10687679,173
10846,3483588,5,985694,986177,985935,483
10847,3483588,5,18468304,18468387,18468345,83
10848,3483589,1,4740890,4741697,4741293,807
10849,3483589,1,24418859,24420392,24419625,1533
10850,3483589,1,25231943,25232405,25232174,462
10851,3483589,2,4996552,4996654,4996603,102
10852,3483589,2,17220288,17220305,17220296,17
10853,3483589,2,19467282,19467472,19467377,190
10854,3483589,4,14420161,14420179,14420170,18
10855,3483589,5,7993978,7994166,7994072,188
10856,3483589,5,24095745,24098627,24097186,2882
10857,3483590,1,16228502,16229025,16228763,523
10858,3483590,1,24664382,24664551,24664466,169
10859,3483590,2,8323416,8323510,8323463,94
10860,3483590,3,1058793,1059529,1059161,736
10861,3483590,3,11602008,11602084,11602046,76
10862,3483590,4,6715086,6716390,6715738,1304
10863,3483590,5,7839493,7839508,7839500,15
10864,3483590,5,13879478,13879520,13879499,42
10865,3483591,1,1534528,1534695,1534611,167
10866,3483591,1,17104883,17105038,17104960,155
10867,3483591,1,23504812,23509118,23506965,4306
10868,3483591,2,7564938,7565016,7564977,78
10869,3483591,2,9242252,9242262,9242257,10
10870,3483591,3,3715964,3717750,3716857,1786
10871,3483591,3,17571462,17572249,17571855,787
10872,3483591,5,1368138,1368458,1368298,320
10873,3483591,5,17191168,17191421,17191294,253
10874,3483591,5,22270211,22270290,22270250,79
10875,3483592,1,10667472,10668630,10668051,1158
10876,3483592,1,26428206,26428823,26428514,617
10877,3483592,2,8323135,8323385,8323260,250
10878,3483592,2,9932888,9933497,9933192,609
10879,3483592,3,3502209,3502795,3502502,586
10880,3483592,4,14975069,14975325,14975197,256
10881,3483592,5,8687591,8687646,8687618,55
10882,3483592,5,21321023,21323157,21322090,2134
10883,3483593,1,29229860,29232758,29231309,2898
10884,3483593,2,1027083,1027225,1027154,142
10885,3483593,2,18281010,18281066,18281038,56
10886,3483593,3,8474533,8474685,8474609,152
10887,3483593,3,9526174,9526254,9526214,80
10888,3483593,4,124458,125130,124794,672
10889,3483593,5,2653357,2654629,2653993,1272
10890,3483593,5,18998730,18998808,18998769,78
10891,3483594,1,23655453,23655913,23655683,460
10892,3483594,1,30365039,30365147,30365093,108
10893,3483594,2,6791664,6795275,6793469,3611
10894,3483594,2,11340906,11343739,11342322,2833
10895,3483594,3,644017,646234,645125,2217
10896,3483594,3,1067238,1067376,1067307,138
10897,3483594,3,11163448,11163570,11163509,122
10898,3483594,4,5162823,5163015,5162919,192
10899,3483594,4,17217247,17217307,17217277,60
10900,3483594,4,18492629,18492664,18492646,35
10901,3483594,5,1922754,1922966,1922860,212
10902,3483595,1,19288145,19290099,19289122,1954
10903,3483595,1,30015586,30015888,30015737,302
10904,3483595,2,837271,839806,838538,2535
10905,3483595,2,17711058,17711280,17711169,222
10906,3483595,4,202156,202361,202258,205
10907,3483595,4,9730445,9730741,9730593,296
10908,3483595,4,16660456,16664435,16662445,3979
10909,3483595,5,5400356,5401328,5400842,972
10910,3483595,5,26306505,26306645,26306575,140
10911,3483596,1,22880772,22881712,22881242,940
10912,3483596,2,4856775,4857030,4856902,255
10913,3483596,2,8248999,8249251,8249125,252
10914,3483596,2,19010630,19010800,19010715,170
10915,3483596,4,7724510,7727207,7725858,2697
10916,3483596,4,17544468,17545274,17544871,806
10917,3483596,5,8699459,8699478,8699468,19
10918,3483596,5,19189572,19190196,19189884,624
10919,3483597,1,25618047,25619203,25618625,1156
10920,3483597,2,5069851,5069937,5069894,86
10921,3483597,3,18798995,18799004,18798999,9
10922,3483597,4,8599216,8599338,8599277,122
10923,3483598,3,16379655,16380223,16379939,568
10924,3483598,4,1530287,1530471,1530379,184
10925,3483598,4,9562840,9562938,9562889,98
10926,3483598,5,1282433,1282518,1282475,85
10927,3483598,5,16600136,16600871,16600503,735
10928,3483598,5,21366359,21366756,21366557,397
10929,3483599,2,7755164,7755449,7755306,285
10930,3483599,3,1983700,1984116,1983908,416
10931,3483599,3,9057867,9058653,9058260,786
10932,3483599,3,18860061,18861154,18860607,1093
10933,3483599,3,19444630,19444669,19444649,39
10934,3483599,4,10528314,10528337,10528325,23
10935,3483599,5,5401938,5402636,5402287,698
10936,3483599,5,17211425,17211493,17211459,68
10937,3483599,5,18182994,18183026,18183010,32
10938,3483600,1,9573359,9574201,9573780,842
10939,3483600,1,24804653,24804817,24804735,164
10940,3483600,1,26418261,26418294,26418277,33
10941,3483600,2,10509433,10509563,10509498,130
10942,3483600,3,929685,930409,930047,724
10943,3483600,3,16831918,16832002,16831960,84
10944,3483600,4,844328,844339,844333,11
10945,3483600,4,6837468,6837718,6837593,250
10946,3483600,5,18284625,18285154,18284889,529
10947,3483601,1,8712687,8713059,8712873,372
10948,3483601,2,10660980,10662588,10661784,1608
10949,3483601,3,8237053,8237061,8237057,8
10950,3483601,3,11102654,11103051,11102852,397
10951,3483601,4,4842944,4844006,4843475,1062
10952,3483601,5,7980093,7980174,7980133,81
10953,3483601,5,10185234,10186423,10185828,1189
10954,3483601,5,25419018,25420380,25419699,1362
10955,3483602,1,18760429,18760713,18760571,284
10956,3483602,2,7671162,7671184,7671173,22
10957,3483602,2,18370280,18370469,18370374,189
10958,3483602,4,5312942,5314654,5313798,1712
10959,3483602,4,13269515,13269568,13269541,53
10960,3483602,4,16665688,16665896,16665792,208
10961,3483602,5,13195275,13195346,13195310,71
10962,3483602,5,23339072,23339228,23339150,156
10963,3483603,1,19077588,19077612,19077600,24
10964,3483603,3,17525796,17526786,17526291,990
10965,3483603,5,9323292,9323829,9323560,537
10966,3483603,5,18722155,18722200,18722177,45
10967,3483604,1,27641790,27642304,27642047,514
10968,3483604,2,2324443,2324616,2324529,173
10969,3483604,3,6229519,6229529,6229524,10
10970,3483604,4,1609804,1610088,1609946,284
10971,3483604,4,14675204,14678196,14676700,2992
10972,3483604,5,19024180,19024973,19024576,793
10973,3483605,1,1830662,1831520,1831091,858
10974,3483605,1,6491685,6491713,6491699,28
10975,3483605,1,10139029,10139815,10139422,786
10976,3483605,2,2920270,2920737,2920503,467
10977,3483605,3,9920558,9920715,9920636,157
10978,3483605,4,7382079,7382252,7382165,173
10979,3483605,4,10078419,10078997,10078708,578
10980,3483605,5,22997204,22997470,22997337,266
10981,3483606,1,5742739,5743853,5743296,1114
10982,3483606,1,22574385,22574465,22574425,80
10983,3483606,2,12163128,12163209,12163168,81
10984,3483606,2,17415579,17415695,17415637,116
10985,3483606,2,17503121,17504152,17503636,1031
10986,3483606,4,9041766,9041834,9041800,68
10987,3483606,4,17813091,17813689,17813390,598
10988,3483606,5,1741904,1742455,1742179,551
10989,3483606,5,2180196,2180240,2180218,44
10990,3483606,5,21844080,21844117,21844098,37
10991,3483607,1,1157357,1158465,1157911,1108
10992,3483607,1,8355199,8355480,8355339,281
10993,3483607,1,16787516,16788237,16787876,721
10994,3483607,2,1070745,1071050,1070897,305
10995,3483607,4,918540,919317,918928,777
10996,3483607,5,822053,822142,822097,89
10997,3483608,1,1549147,1549454,1549300,307
10998,3483608,1,6462312,6462742,6462527,430
10999,3483608,1,16844496,16844751,16844623,255
11000,3483608,1,26509398,26509576,26509487,178
11001,3483608,2,1133676,1133952,1133814,276
11002,3483608,2,18508953,18510786,18509869,1833
11003,3483608,3,9849605,9852764,9851184,3159
11004,3483609,1,7387535,7389396,7388465,1861
11005,3483609,2,1192724,1193708,1193216,984
11006,3483609,2,16817826,16818517,16818171,691
11007,3483609,4,280328,280777,280552,449
11008,3483609,4,8854418,8854807,8854612,389
11009,3483609,4,9301624,9304128,9302876,2504
11010,3483609,5,6611335,6612411,6611873,1076
11011,3483610,2,7674020,7674695,7674357,675
11012,3483610,3,178384,178782,178583,398
11013,3483610,4,574066,574482,574274,416
11014,3483610,4,8956790,8957081,8956935,291
11015,3483610,4,16760359,16760726,16760542,367
11016,3483610,5,10168440,10169300,10168870,860
11017,3483610,5,14864807,14865914,14865360,1107
11018,3483611,1,20772484,20774844,20773664,2360
11019,3483611,2,1187340,1187377,1187358,37
11020,3483611,2,16700928,16702595,16701761,1667
11021,3483611,3,7572802,7572997,7572899,195
11022,3483611,4,5124973,5125076,5125024,103
11023,3483611,4,5639006,5639501,5639253,495
11024,3483611,5,23989672,23989694,23989683,22
11025,3483612,1,666158,666861,666509,703
11026,3483612,1,1163523,1163842,1163682,319
11027,3483612,1,8372730,8373056,8372893,326
11028,3483612,1,21569877,21569913,21569895,36
11029,3483612,1,22865309,22865725,22865517,416
11030,3483612,2,11119762,11125185,11122473,5423
11031,3483612,3,11549687,11549705,11549696,18
11032,3483612,4,576110,576140,576125,30
11033,3483612,4,6282632,6282849,6282740,217
11034,3483612,5,7084130,7085123,7084626,993
11035,3483612,5,26068883,26068913,26068898,30
11036,3483613,1,19095696,19095945,19095820,249
11037,3483613,1,19681868,19682300,19682084,432
11038,3483613,1,25996180,25996693,25996436,513
11039,3483613,2,8281565,8282067,8281816,502
11040,3483613,4,10138761,10138986,10138873,225
11041,3483613,5,6089269,6089917,6089593,648
11042,3483613,5,25753586,25753717,25753651,131
11043,3483614,1,17200272,17200316,17200294,44
11044,3483614,1,24579047,24579817,24579432,770
11045,3483614,2,7752337,7753412,7752874,1075
11046,3483614,3,829819,830684,830251,865
11047,3483614,4,130310,131413,130861,1103
11048,3483614,4,9752298,9753887,9753092,1589
11049,3483614,5,575916,575995,575955,79
11050,3483614,5,7211652,7211904,7211778,252
11051,3483614,5,17422224,17422702,17422463,478
11052,3483614,5,25456139,25457984,25457061,1845
11053,3483615,1,9077075,9077832,9077453,757
11054,3483615,1,24686153,24687117,24686635,964
11055,3483615,2,12945846,12946156,12946001,310
11056,3483615,3,5146020,5147492,5146756,1472
11057,3483615,3,7878519,7878713,7878616,194
11058,3483615,4,11887169,11888977,11888073,1808
11059,3483615,5,10454252,10454682,10454467,430
11060,3483616,1,8469380,8471355,8470367,1975
11061,3483616,1,16775720,16775816,16775768,96
11062,3483616,1,25448571,25449596,25449083,1025
11063,3483616,3,7362159,7362707,7362433,548
11064,3483616,3,17282013,17282156,17282084,143
11065,3483616,5,5298878,5298937,5298907,59
11066,3483616,5,6443139,6443354,6443246,215
11067,3483616,5,13693634,13694053,13693843,419
11068,3483617,1,4275765,4275834,4275799,69
11069,3483617,2,11736919,11737119,11737019,200
11070,3483617,2,14912260,14912493,14912376,233
11071,3483617,3,12100030,12100092,12100061,62
11072,3483617,3,16053969,16054135,16054052,166
11073,3483617,4,6256924,6257012,6256968,88
11074,3483617,4,14942881,14942971,14942926,90
11075,3483617,5,8727722,8728116,8727919,394
11076,3483617,5,15277768,15280464,15279116,2696
11077,3483617,5,22051502,22051770,22051636,268
11078,3483618,1,8940117,8940149,8940133,32
11079,3483618,1,16963423,16964003,16963713,580
11080,3483618,1,24764140,24764623,24764381,483
11081,3483618,1,27529678,27529916,27529797,238
11082,3483618,4,6298462,6298903,6298682,441
11083,3483618,4,10338931,10339221,10339076,290
11084,3483618,5,3857820,3858445,3858132,625
11085,3483618,5,10371928,10372775,10372351,847
11086,3483619,1,24658883,24660095,24659489,1212
11087,3483619,2,482882,483299,483090,417
11088,3483619,2,1132625,1132666,1132645,41
11089,3483619,2,19105887,19106517,19106202,630
11090,3483619,3,1923274,1923989,1923631,715
11091,3483619,3,11304277,11304687,11304482,410
11092,3483619,4,8929351,8929941,8929646,590
11093,3483619,4,17517709,17518447,17518078,738
11094,3483620,1,5508253,5508718,5508485,465
11095,3483620,1,26586874,26591233,26589053,4359
11096,3483620,2,2024743,2024893,2024818,150
11097,3483620,3,344077,344277,344177,200
11098,3483620,3,19201582,19206626,19204104,5044
11099,3483620,4,415830,416731,416280,901
11100,3483620,4,9138018,9138185,9138101,167
11101,3483621,1,9196886,9197202,9197044,316
11102,3483621,2,10026308,10030799,10028553,4491
11103,3483621,2,10211118,10211123,10211120,5
11104,3483621,2,13370401,13370598,13370499,197
11105,3483621,3,4755636,4757215,4756425,1579
11106,3483621,4,12450369,12450579,12450474,210
11107,3483621,5,761900,762689,762294,789
11108,3483622,1,16642993,16643196,16643094,203
11109,3483622,2,9700065,9700552,9700308,487
11110,3483622,4,1439945,1440963,1440454,1018
11111,3483622,4,12907148,12907199,12907173,51
11112,3483622,5,1933196,1933544,1933370,348
11113,3483622,5,20326601,20326707,20326654,106
11114,3483623,1,12972124,12972141,12972132,17
11115,3483623,1,26243213,26245139,26244176,1926
11116,3483623,2,479089,479388,479238,299
11117,3483623,3,906192,906827,906509,635
11118,3483623,3,16566849,16566917,16566883,68
11119,3483623,4,7317154,7317211,7317182,57
11120,3483623,4,8218801,8219590,8219195,789
11121,3483623,4,17486207,17486898,17486552,691
11122,3483623,5,10261698,10262010,10261854,312
11123,3483623,5,18138522,18138537,18138529,15
11124,3483623,5,24669964,24670045,24670004,81
11125,3483624,2,8559330,8560389,8559859,1059
11126,3483624,2,13792652,13792750,13792701,98
11127,3483624,3,4652751,4653828,4653289,1077
11128,3483624,3,12667775,12668018,12667896,243
11129,3483625,1,8160768,8160857,8160812,89
11130,3483625,1,17101550,17104874,17103212,3324
11131,3483625,3,22222879,22224300,22223589,1421
11132,3483625,5,8944409,8945885,8945147,1476
11133,3483625,5,16141110,16141173,16141141,63
11134,3483626,2,2183518,2184033,2183775,515
11135,3483626,4,943668,944254,943961,586
11136,3483626,4,13857009,13857209,13857109,200
11137,3483626,5,26513836,26513981,26513908,145
11138,3483627,2,6032921,6033611,6033266,690
11139,3483627,2,10483410,10483462,10483436,52
11140,3483627,3,21751387,21751865,21751626,478
11141,3483627,5,16929738,16929794,16929766,56
11142,3483628,1,16644049,16644086,16644067,37
11143,3483628,1,29389627,29391390,29390508,1763
11144,3483628,2,9156966,9157405,9157185,439
11145,3483628,2,19075608,19075800,19075704,192
11146,3483628,3,20449599,20449616,20449607,17
11147,3483628,4,10362709,10364749,10363729,2040
11148,3483628,4,18090194,18090242,18090218,48
11149,3483628,5,4107107,4107157,4107132,50
11150,3483629,2,6345574,6346580,6346077,1006
11151,3483629,4,407761,407762,407761,1
11152,3483629,4,5711724,5711811,5711767,87
11153,3483629,5,2607621,2610597,2609109,2976
11154,3483629,5,9655246,9656102,9655674,856
11155,3483630,1,4429054,4429640,4429347,586
11156,3483630,2,7329097,7329232,7329164,135
11157,3483630,2,9548392,9548770,9548581,378
11158,3483630,3,20044283,20045037,20044660,754
11159,3483630,4,6359252,6359299,6359275,47
11160,3483630,4,9253974,9254191,9254082,217
11161,3483630,5,10266061,10266273,10266167,212
11162,3483630,5,13590466,13592779,13591622,2313
11163,3483631,1,7699074,7700049,7699561,975
11164,3483631,2,1682530,1682609,1682569,79
11165,3483631,2,6776133,6776201,6776167,68
11166,3483631,3,10956243,10959065,10957654,2822
11167,3483631,4,14169675,14170327,14170001,652
11168,3483631,4,17514471,17514602,17514536,131
11169,3483631,5,10168596,10169300,10168948,704
11170,3483631,5,20458517,20460108,20459312,1591
11171,3483632,1,16127874,16127975,16127924,101
11172,3483632,1,25785306,25785845,25785575,539
11173,3483632,2,9116757,9117263,9117010,506
11174,3483632,2,11590970,11591256,11591113,286
11175,3483632,3,11120922,11121602,11121262,680
11176,3483632,4,6971626,6971666,6971646,40
11177,3483632,4,17996990,17998829,17997909,1839
11178,3483632,5,960204,960360,960282,156
11179,3483632,5,17723346,17723381,17723363,35
11180,3483632,5,18635168,18635295,18635231,127
11181,3483633,1,3892940,3894207,3893573,1267
11182,3483633,1,9100415,9100767,9100591,352
11183,3483633,1,29503415,29503945,29503680,530
11184,3483633,2,2925013,2925053,2925033,40
11185,3483633,2,8071939,8072207,8072073,268
11186,3483633,3,8240796,8241593,8241194,797
11187,3483633,5,633492,635575,634533,2083
11188,3483634,1,2016331,2016428,2016379,97
11189,3483634,1,10136511,10137769,10137140,1258
11190,3483634,1,18859358,18859490,18859424,132
11191,3483634,1,25225683,25225703,25225693,20
11192,3483634,2,681510,682346,681928,836
11193,3483634,2,7277127,7277975,7277551,848
11194,3483634,2,18003487,18005825,18004656,2338
11195,3483634,3,5448177,5451225,5449701,3048
11196,3483634,5,6852664,6853524,6853094,860
11197,3483634,5,19858256,19858559,19858407,303
11198,3483635,1,11083326,11084940,11084133,1614
11199,3483635,3,7509679,7509802,7509740,123
11200,3483635,3,16617729,16618206,16617967,477
11201,3483635,5,5811572,5811762,5811667,190
11202,3483635,5,14531669,14533319,14532494,1650
11203,3483635,5,22963302,22963764,22963533,462
11204,3483635,5,25074051,25075116,25074583,1065
11205,3483636,1,9857979,9858809,9858394,830
11206,3483636,1,11572413,11572814,11572613,401
11207,3483636,1,21993561,21993714,21993637,153
11208,3483636,2,83327,83342,83334,15
11209,3483636,2,7263215,7263535,7263375,320
11210,3483636,2,10895936,10895938,10895937,2
11211,3483636,3,6130299,6130494,6130396,195
11212,3483636,3,22363529,22363685,22363607,156
11213,3483636,4,2827534,2827577,2827555,43
11214,3483636,5,2071123,2071475,2071299,352
11215,3483636,5,8371088,8371197,8371142,109
11216,3483637,1,17292338,17293332,17292835,994
11217,3483637,1,28699749,28707111,28703430,7362
11218,3483637,2,232631,233250,232940,619
11219,3483637,3,10334820,10336923,10335871,2103
11220,3483637,3,14940751,14940974,14940862,223
11221,3483638,1,6764851,6766446,6765648,1595
11222,3483638,1,12427248,12427597,12427422,349
11223,3483638,1,18951698,18951767,18951732,69
11224,3483638,1,24391309,24391892,24391600,583
11225,3483638,2,7984398,7985077,7984737,679
11226,3483638,2,12795539,12796307,12795923,768
11227,3483638,3,20643198,20643712,20643455,514
11228,3483638,4,1201380,1201946,1201663,566
11229,3483638,4,7739905,7741024,7740464,1119
11230,3483638,5,25942516,25942775,25942645,259
11231,3483639,1,5182982,5183146,5183064,164
11232,3483639,1,6642204,6642322,6642263,118
11233,3483639,4,6582649,6582805,6582727,156
11234,3483639,4,14529582,14529874,14529728,292
11235,3483639,5,1769034,1769165,1769099,131
11236,3483639,5,10637741,10639381,10638561,1640
11237,3483641,2,6385234,6385286,6385260,52
11238,3483641,3,1089256,1089718,1089487,462
11239,3483641,4,10522966,10523201,10523083,235
11240,3483641,5,9157390,9157606,9157498,216
11241,3483641,5,14916300,14916386,14916343,86
11242,3483642,1,5956670,5959950,5958310,3280
11243,3483642,1,13469557,13470165,13469861,608
11244,3483642,1,24929154,24930423,24929788,1269
11245,3483642,2,9921899,9922001,9921950,102
11246,3483642,3,11402436,11403041,11402738,605
11247,3483642,3,15688054,15688073,15688063,19
11248,3483642,5,13474947,13475042,13474994,95
11249,3483643,1,10557646,10557834,10557740,188
11250,3483643,1,28916864,28916994,28916929,130
11251,3483643,2,10227690,10227779,10227734,89
11252,3483643,3,5079747,5079992,5079869,245
11253,3483643,4,17885599,17887652,17886625,2053
11254,3483643,5,26764872,26765053,26764962,181
11255,3483644,1,10487111,10487312,10487211,201
11256,3483644,1,24450728,24451101,24450914,373
11257,3483644,3,849180,850136,849658,956
11258,3483644,5,9831811,9831922,9831866,111
11259,3483644,5,16181915,16184355,16183135,2440
11260,3483644,5,26102845,26102879,26102862,34
11261,3483645,1,3230772,3230785,3230778,13
11262,3483645,1,6344160,6345007,6344583,847
11263,3483645,1,11340136,11340306,11340221,170
11264,3483645,1,15989469,15989607,15989538,138
11265,3483645,1,21588536,21588589,21588562,53
11266,3483645,1,22438274,22439976,22439125,1702
11267,3483645,1,25352479,25353686,25353082,1207
11268,3483645,2,1714889,1719022,1716955,4133
11269,3483645,3,3309455,3309571,3309513,116
11270,3483645,4,7095582,7095636,7095609,54
11271,3483645,5,14609415,14610110,14609762,695
11272,3483645,5,25123578,25125471,25124524,1893
11273,3483646,1,15945917,15946453,15946185,536
11274,3483646,2,6213812,6214560,6214186,748
11275,3483646,2,7808773,7809845,7809309,1072
11276,3483646,3,6567202,6567387,6567294,185
11277,3483646,4,6221583,6221932,6221757,349
11278,3483646,5,15372068,15373633,15372850,1565
11279,3483647,1,24339720,24340768,24340244,1048
11280,3483647,1,24761629,24763022,24762325,1393
11281,3483647,1,26529743,26531838,26530790,2095
11282,3483647,3,3345812,3347702,3346757,1890
11283,3483647,3,4657951,4658251,4658101,300
11284,3483647,3,8514912,8516089,8515500,1177
11285,3483647,4,16360974,16361046,16361010,72
11286,3483647,5,8656829,8657144,8656986,315
11287,3483647,5,16238223,16238561,16238392,338
11288,3483648,1,8199058,8199854,8199456,796
11289,3483648,1,26320431,26320793,26320612,362
11290,3483648,2,191007,191137,191072,130
11291,3483648,3,5419998,5421245,5420621,1247
11292,3483648,3,10689332,10690098,10689715,766
11293,3483648,4,5425377,5425596,5425486,219
11294,3483648,4,11565981,11566076,11566028,95
11295,3483648,4,16629232,16629691,16629461,459
11296,3483648,5,16863180,16863832,16863506,652
11297,3483649,1,7840015,7841168,7840591,1153
11298,3483649,2,6321483,6321843,6321663,360
11299,3483649,2,7703408,7705440,7704424,2032
11300,3483649,2,17096685,17096732,17096708,47
11301,3483649,3,16874486,16874806,16874646,320
11302,3483649,5,17773681,17773962,17773821,281
11303,3483650,1,8586537,8586951,8586744,414
11304,3483650,1,19231003,19238824,19234913,7821
11305,3483650,2,6817148,6817305,6817226,157
11306,3483650,2,8294095,8294805,8294450,710
11307,3483650,3,7797104,7797372,7797238,268
11308,3483650,3,9760628,9761448,9761038,820
11309,3483650,4,681899,682033,681966,134
11310,3483650,4,5158991,5159038,5159014,47
11311,3483650,5,3318726,3318849,3318787,123
11312,3483650,5,16851590,16852248,16851919,658
11313,3483651,1,179753,180812,180282,1059
11314,3483651,1,7208484,7210388,7209436,1904
11315,3483651,1,12512186,12512269,12512227,83
11316,3483651,2,11333567,11334796,11334181,1229
11317,3483651,2,16106917,16107403,16107160,486
11318,3483651,3,10206606,10206654,10206630,48
11319,3483651,3,16615311,16617419,16616365,2108
11320,3483651,3,19557061,19557815,19557438,754
11321,3483651,3,22258419,22258679,22258549,260
11322,3483651,4,14278650,14278684,14278667,34
11323,3483651,5,8106909,8108936,8107922,2027
11324,3483651,5,9723104,9723133,9723118,29
11325,3483651,5,25225306,25226657,25225981,1351
11326,3483652,1,1429954,1431044,1430499,1090
11327,3483652,1,28288886,28290347,28289616,1461
11328,3483652,2,18763686,18767705,18765695,4019
11329,3483652,3,1921116,1923274,1922195,2158
11330,3483652,3,18576295,18576751,18576523,456
11331,3483652,4,5121591,5122182,5121886,591
11332,3483653,1,13061762,13062494,13062128,732
11333,3483653,1,26118958,26121434,26120196,2476
11334,3483653,2,6540310,6540748,6540529,438
11335,3483653,4,7272687,7274195,7273441,1508
11336,3483653,5,7946361,7946585,7946473,224
11337,3483653,5,22903866,22903879,22903872,13
11338,3483654,2,1152772,1152786,1152779,14
11339,3483654,2,18260876,18261167,18261021,291
11340,3483654,3,16823705,16823828,16823766,123
11341,3483654,4,7440769,7440825,7440797,56
11342,3483654,5,21326773,21327087,21326930,314
11343,3483655,1,13122762,13122770,13122766,8
11344,3483655,1,17690337,17690573,17690455,236
11345,3483655,1,28931849,28932250,28932049,401
11346,3483655,2,1187340,1187377,1187358,37
11347,3483655,2,13811790,13811888,13811839,98
11348,3483655,3,1451081,1451422,1451251,341
11349,3483655,4,6272690,6272767,6272728,77
11350,3483655,4,10890768,10891992,10891380,1224
11351,3483655,4,17669326,17669581,17669453,255
11352,3483655,5,4234109,4234993,4234551,884
11353,3483656,1,17330106,17330406,17330256,300
11354,3483656,1,26343820,26344044,26343932,224
11355,3483656,2,2242527,2243035,2242781,508
11356,3483656,2,15960597,15960649,15960623,52
11357,3483656,3,8926127,8926390,8926258,263
11358,3483656,3,9462366,9464360,9463363,1994
11359,3483656,4,5765803,5766806,5766304,1003
11360,3483656,4,6819258,6820566,6819912,1308
11361,3483657,2,1559002,1559039,1559020,37
11362,3483657,2,19307610,19308115,19307862,505
11363,3483657,4,7796123,7796977,7796550,854
11364,3483657,5,15003635,15003912,15003773,277
11365,3483657,5,24131240,24132719,24131979,1479
11366,3483658,1,1559810,1560578,1560194,768
11367,3483658,1,17387746,17388546,17388146,800
11368,3483658,1,28295856,28297242,28296549,1386
11369,3483658,2,15766822,15767187,15767004,365
11370,3483658,4,7787103,7787353,7787228,250
11371,3483658,4,11520649,11521774,11521211,1125
11372,3483658,5,10799586,10800100,10799843,514
11373,3483659,1,8026803,8026936,8026869,133
11374,3483659,1,10462986,10463899,10463442,913
11375,3483659,4,1211036,1211231,1211133,195
11376,3483660,2,7368339,7368376,7368357,37
11377,3483660,4,315238,315426,315332,188
11378,3483660,4,710316,711777,711046,1461
11379,3483660,5,5624885,5626283,5625584,1398
11380,3483661,1,12003588,12003659,12003623,71
11381,3483661,1,23447580,23451526,23449553,3946
11382,3483661,2,2588153,2588547,2588350,394
11383,3483661,2,7407869,7407940,7407904,71
11384,3483661,3,9902623,9902913,9902768,290
11385,3483661,4,7328347,7328459,7328403,112
11386,3483661,4,15901231,15902775,15902003,1544
11387,3483661,5,829572,830147,829859,575
11388,3483661,5,15747824,15748435,15748129,611
11389,3483662,2,7524842,7525079,7524960,237
11390,3483662,2,11209133,11210094,11209613,961
11391,3483662,3,9490350,9490531,9490440,181
11392,3483662,3,16371912,16371945,16371928,33
11393,3483662,4,644999,645120,645059,121
11394,3483662,4,7382593,7382774,7382683,181
11395,3483662,5,6828808,6830571,6829689,1763
11396,3483662,5,23664939,23665365,23665152,426
11397,3483662,5,26469629,26470877,26470253,1248
11398,3483663,1,7974828,7975171,7974999,343
11399,3483663,1,25544637,25547782,25546209,3145
11400,3483663,1,25708767,25712974,25710870,4207
11401,3483663,2,18466907,18469887,18468397,2980
11402,3483663,3,16366756,16367037,16366896,281
11403,3483663,3,18804971,18805780,18805375,809
11404,3483663,4,42077,42584,42330,507
11405,3483663,4,6319832,6320063,6319947,231
11406,3483663,4,14879872,14880052,14879962,180
11407,3483663,4,18098149,18098410,18098279,261
11408,3483663,5,24114077,24116853,24115465,2776
11409,3483664,1,17221640,17222127,17221883,487
11410,3483664,2,616132,616485,616308,353
11411,3483664,2,19044491,19045020,19044755,529
11412,3483664,4,6424400,6424499,6424449,99
11413,3483664,4,12478360,12479400,12478880,1040
11414,3483664,5,22174376,22174708,22174542,332
11415,3483665,1,4540314,4540457,4540385,143
11416,3483665,1,10891261,10891396,10891328,135
11417,3483665,1,27000761,27001469,27001115,708
11418,3483665,2,204042,204126,204084,84
11419,3483665,2,1470623,1471148,1470885,525
11420,3483665,2,15133574,15134886,15134230,1312
11421,3483665,3,8927921,8927957,8927939,36
11422,3483665,3,15754432,15754534,15754483,102
11423,3483665,3,22103487,22103986,22103736,499
11424,3483665,4,296823,297772,297297,949
11425,3483665,4,18274637,18275315,18274976,678
11426,3483665,5,18391104,18392800,18391952,1696
11427,3483666,1,8141793,8142655,8142224,862
11428,3483666,2,6916000,6916155,6916077,155
11429,3483666,2,18994104,18995250,18994677,1146
11430,3483666,3,19511263,19513404,19512333,2141
11431,3483666,4,17279578,17279657,17279617,79
11432,3483666,5,15974893,15975264,15975078,371
11433,3483666,5,25441042,25443928,25442485,2886
11434,3483667,1,5398779,5398882,5398830,103
11435,3483667,1,7859606,7859898,7859752,292
11436,3483667,2,13744362,13744920,13744641,558
11437,3483667,3,3620328,3620894,3620611,566
11438,3483667,3,17245723,17245938,17245830,215
11439,3483667,4,7247605,7247665,7247635,60
11440,3483667,4,17108774,17108929,17108851,155
11441,3483667,5,21874368,21874369,21874368,1
11442,3483668,1,16729576,16730929,16730252,1353
11443,3483668,2,9380143,9380354,9380248,211
11444,3483668,3,8108472,8109014,8108743,542
11445,3483668,4,1436361,1436547,1436454,186
11446,3483668,4,17678216,17679721,17678968,1505
11447,3483668,5,4943553,4944539,4944046,986
11448,3483669,1,4165272,4165357,4165314,85
11449,3483669,1,7739748,7740926,7740337,1178
11450,3483669,2,6536487,6536529,6536508,42
11451,3483669,2,7722206,7722797,7722501,591
11452,3483669,4,6324569,6325256,6324912,687
11453,3483669,5,7226874,7228031,7227452,1157
11454,3483669,5,14915900,14916386,14916143,486
11455,3483670,1,26485171,26485808,26485489,637
11456,3483670,2,108609,108976,108792,367
11457,3483670,2,16921638,16921698,16921668,60
11458,3483670,3,828799,829696,829247,897
11459,3483670,3,11285181,11285387,11285284,206
11460,3483670,4,795897,796074,795985,177
11461,3483670,4,10269447,10271931,10270689,2484
11462,3483671,2,2323827,2323853,2323840,26
11463,3483671,3,17999004,18001393,18000198,2389
11464,3483671,4,216421,216538,216479,117
11465,3483671,4,7314683,7317154,7315918,2471
11466,3483671,5,7278229,7278231,7278230,2
11467,3483671,5,22895085,22896550,22895817,1465
11468,3483672,1,10421805,10423689,10422747,1884
11469,3483672,1,22823144,22823329,22823236,185
11470,3483672,2,6533079,6533803,6533441,724
11471,3483672,2,11126751,11127064,11126907,313
11472,3483672,5,4727803,4729881,4728842,2078
11473,3483673,1,6261475,6261740,6261607,265
11474,3483673,1,30138527,30139205,30138866,678
11475,3483673,2,8581833,8582411,8582122,578
11476,3483673,2,17778649,17779211,17778930,562
11477,3483673,3,2199226,2199627,2199426,401
11478,3483673,3,14748480,14751010,14749745,2530
11479,3483673,4,9120481,9121981,9121231,1500
11480,3483673,5,6229969,6231620,6230794,1651
11481,3483674,1,5422131,5422254,5422192,123
11482,3483674,1,23053344,23053378,23053361,34
11483,3483674,1,28151760,28152727,28152243,967
11484,3483674,2,1420023,1420135,1420079,112
11485,3483674,2,7497783,7498635,7498209,852
11486,3483674,4,10754660,10756996,10755828,2336
11487,3483674,5,7114564,7114839,7114701,275
11488,3483674,5,23066951,23067028,23066989,77
11489,3483675,1,4233692,4235774,4234733,2082
11490,3483675,2,7941821,7942269,7942045,448
11491,3483675,2,9508063,9509226,9508644,1163
11492,3483675,3,8279371,8280532,8279951,1161
11493,3483675,3,20770834,20771682,20771258,848
11494,3483675,4,477427,478305,477866,878
11495,3483675,5,14889845,14890227,14890036,382
11496,3483676,1,2124478,2125730,2125104,1252
11497,3483676,1,5383039,5383311,5383175,272
11498,3483676,1,9383904,9386995,9385449,3091
11499,3483676,1,20942258,20942693,20942475,435
11500,3483676,2,1025551,1025665,1025608,114
11501,3483676,2,2271719,2272809,2272264,1090
11502,3483676,2,15498141,15498237,15498189,96
11503,3483676,3,411324,411963,411643,639
11504,3483676,3,8611407,8611488,8611447,81
11505,3483676,3,10746595,10747239,10746917,644
11506,3483676,4,995797,1002544,999170,6747
11507,3483676,4,11124935,11125424,11125179,489
11508,3483676,4,16100045,16101932,16100988,1887
11509,3483676,5,4967168,4967288,4967228,120
11510,3483676,5,16003462,16003502,16003482,40
11511,3483677,1,17712607,17712636,17712621,29
11512,3483677,2,359467,359581,359524,114
11513,3483677,2,5317420,5317497,5317458,77
11514,3483677,2,18820510,18820679,18820594,169
11515,3483677,3,3073260,3075252,3074256,1992
11516,3483677,4,162957,165676,164316,2719
11517,3483677,4,6025688,6025835,6025761,147
11518,3483677,4,8502843,8503626,8503234,783
11519,3483677,5,8092759,8093394,8093076,635
11520,3483677,5,25289549,25289550,25289549,1
11521,3483678,2,2810604,2810938,2810771,334
11522,3483678,3,9220092,9220130,9220111,38
11523,3483678,5,19734693,19734873,19734783,180
11524,3483679,2,5915078,5915164,5915121,86
11525,3483679,2,16147974,16148305,16148139,331
11526,3483679,4,571626,573404,572515,1778
11527,3483679,5,5894225,5895100,5894662,875
11528,3483680,1,26410551,26411409,26410980,858
11529,3483680,2,7308767,7309831,7309299,1064
11530,3483680,2,11622488,11623150,11622819,662
11531,3483680,2,15941739,15943956,15942847,2217
11532,3483680,3,21717385,21717865,21717625,480
11533,3483680,4,114177,114278,114227,101
11534,3483680,4,5142905,5142950,5142927,45
11535,3483680,4,7247665,7247948,7247806,283
11536,3483680,5,515823,517201,516512,1378
11537,3483680,5,15727460,15728048,15727754,588
11538,3483681,1,26730652,26730801,26730726,149
11539,3483681,2,12347861,12349129,12348495,1268
11540,3483681,2,13215665,13217612,13216638,1947
11541,3483681,3,9269392,9270299,9269845,907
11542,3483681,4,18200321,18202776,18201548,2455
11543,3483681,5,9227428,9227675,9227551,247
11544,3483681,5,18226327,18226328,18226327,1
11545,3483682,1,5450614,5450744,5450679,130
11546,3483682,1,17347133,17347205,17347169,72
11547,3483682,2,12402772,12404672,12403722,1900
11548,3483682,2,14262418,14262648,14262533,230
11549,3483682,3,22729247,22729785,22729516,538
11550,3483682,4,180957,180966,180961,9
11551,3483682,4,5379648,5381923,5380785,2275
11552,3483682,4,17468311,17469906,17469108,1595
11553,3483682,5,5431930,5431963,5431946,33
11554,3483682,5,14633943,14635687,14634815,1744
11555,3483683,1,764702,765174,764938,472
11556,3483683,2,5689965,5690028,5689996,63
11557,3483683,2,7655587,7655939,7655763,352
11558,3483683,3,10306909,10307191,10307050,282
11559,3483683,4,5371966,5372087,5372026,121
11560,3483683,5,13882272,13882391,13882331,119
11561,3483684,1,4667249,4670858,4669053,3609
11562,3483684,1,16775343,16775611,16775477,268
11563,3483684,1,24412261,24412416,24412338,155
11564,3483684,1,28631972,28632788,28632380,816
11565,3483684,2,7249654,7251528,7250591,1874
11566,3483684,3,10994874,10995296,10995085,422
11567,3483684,3,16629402,16629477,16629439,75
11568,3483684,4,715961,715974,715967,13
11569,3483684,5,1382369,1382574,1382471,205
11570,3483684,5,20009753,20009903,20009828,150
11571,3483685,1,15988917,15989469,15989193,552
11572,3483685,1,18405765,18406039,18405902,274
11573,3483685,3,10716094,10716384,10716239,290
11574,3483685,3,23183320,23183460,23183390,140
11575,3483685,4,6093830,6094616,6094223,786
11576,3483685,4,14724304,14726804,14725554,2500
11577,3483685,5,19371638,19372267,19371952,629
11578,3483686,1,4290013,4290559,4290286,546
11579,3483686,1,12695071,12696979,12696025,1908
11580,3483686,1,24333216,24335136,24334176,1920
11581,3483686,1,28238620,28239892,28239256,1272
11582,3483686,2,1640902,1641654,1641278,752
11583,3483686,2,5537529,5538375,5537952,846
11584,3483686,2,9246128,9247382,9246755,1254
11585,3483686,4,143460,143674,143567,214
11586,3483686,5,4834977,4835216,4835096,239
11587,3483686,5,18892284,18892496,18892390,212
11588,3483687,1,8352351,8352382,8352366,31
11589,3483687,2,10898029,10898052,10898040,23
11590,3483687,2,13699945,13700211,13700078,266
11591,3483687,3,7647898,7648092,7647995,194
11592,3483687,4,5359546,5359778,5359662,232
11593,3483687,4,14894449,14894792,14894620,343
11594,3483687,5,10386932,10388184,10387558,1252
11595,3483687,5,15774272,15774622,15774447,350
11596,3483687,5,19208260,19208372,19208316,112
11597,3483688,1,7703029,7705248,7704138,2219
11598,3483688,3,2131009,2131416,2131212,407
11599,3483688,4,8863948,8867562,8865755,3614
11600,3483688,5,437971,438032,438001,61
11601,3483688,5,8106684,8108936,8107810,2252
11602,3483688,5,24412413,24412587,24412500,174
11603,3483689,1,5843565,5844538,5844051,973
11604,3483689,1,13077389,13077492,13077440,103
11605,3483689,1,28378273,28378923,28378598,650
11606,3483689,2,10715297,10718141,10716719,2844
11607,3483689,3,10924458,10924799,10924628,341
11608,3483689,3,15674759,15674945,15674852,186
11609,3483689,4,1023562,1026302,1024932,2740
11610,3483689,4,16542770,16544907,16543838,2137
11611,3483689,5,1601667,1602779,1602223,1112
11612,3483689,5,2451985,2452080,2452032,95
11613,3483689,5,7278380,7279006,7278693,626
11614,3483690,1,571284,571420,571352,136
11615,3483690,1,21081354,21081871,21081612,517
11616,3483690,3,4480953,4482098,4481525,1145
11617,3483690,3,10215688,10216886,10216287,1198
11618,3483690,3,19237251,19238233,19237742,982
11619,3483690,3,22715230,22715385,22715307,155
11620,3483690,5,15830441,15830744,15830592,303
11621,3483690,5,20562481,20562707,20562594,226
11622,3483691,1,30411717,30411919,30411818,202
11623,3483691,2,5929349,5929873,5929611,524
11624,3483691,2,16145265,16145325,16145295,60
11625,3483691,4,655654,657521,656587,1867
11626,3483691,5,5898156,5898407,5898281,251
11627,3483692,1,7804984,7805037,7805010,53
11628,3483692,1,13836363,13836761,13836562,398
11629,3483692,3,11075571,11076478,11076024,907
11630,3483692,4,810732,810755,810743,23
11631,3483692,4,9968278,9969438,9968858,1160
11632,3483692,5,5003868,5004524,5004196,656
11633,3483692,5,15374051,15374556,15374303,505
11634,3483692,5,16296197,16296699,16296448,502
11635,3483693,1,5397706,5398374,5398040,668
11636,3483693,2,6666166,6668234,6667200,2068
11637,3483693,3,11282138,11282192,11282165,54
11638,3483693,3,18808967,18809125,18809046,158
11639,3483693,4,16691488,16692240,16691864,752
11640,3483693,5,18096045,18096947,18096496,902
11641,3483693,5,20212685,20213032,20212858,347
11642,3483694,1,7797825,7798124,7797974,299
11643,3483694,1,13982757,13983651,13983204,894
11644,3483694,3,11108169,11108286,11108227,117
11645,3483694,4,799289,799356,799322,67
11646,3483694,4,9969500,9969852,9969676,352
11647,3483694,5,4884968,4885045,4885006,77
11648,3483694,5,15363847,15364453,15364150,606
11649,3483694,5,16307289,16307362,16307325,73
11650,3483695,1,7855896,7855925,7855910,29
11651,3483695,1,11830560,11831571,11831065,1011
11652,3483695,1,22632164,22632212,22632188,48
11653,3483695,2,1867715,1867994,1867854,279
11654,3483695,3,8778814,8779197,8779005,383
11655,3483695,3,17516775,17516945,17516860,170
11656,3483695,3,21387049,21387387,21387218,338
11657,3483695,4,1175430,1175610,1175520,180
11658,3483695,4,7567661,7568261,7567961,600
11659,3483695,5,14916300,14916386,14916343,86
11660,3483695,5,26496382,26496562,26496472,180
11661,3483696,1,21434995,21435005,21435000,10
11662,3483696,3,19710503,19710828,19710665,325
11663,3483696,4,6886477,6886519,6886498,42
11664,3483696,5,557339,557547,557443,208
11665,3483696,5,13865135,13865222,13865178,87
11666,3483696,5,16811855,16812930,16812392,1075
11667,3483697,1,10957222,10957236,10957229,14
11668,3483697,1,28485879,28486451,28486165,572
11669,3483697,4,7130248,7130298,7130273,50
11670,3483697,4,7369626,7370740,7370183,1114
11671,3483697,5,26237555,26238392,26237973,837
11672,3483698,1,18690536,18691598,18691067,1062
11673,3483698,1,19572019,19572450,19572234,431
11674,3483698,1,29369408,29370194,29369801,786
11675,3483698,2,2260830,2261173,2261001,343
11676,3483698,2,4856775,4857030,4856902,255
11677,3483698,2,16108784,16109383,16109083,599
11678,3483698,3,10985735,10986261,10985998,526
11679,3483698,5,25753586,25753717,25753651,131
11680,3483699,1,10921667,10921770,10921718,103
11681,3483699,1,29783647,29783698,29783672,51
11682,3483699,2,6631848,6631851,6631849,3
11683,3483699,2,15493536,15493618,15493577,82
11684,3483699,3,9304363,9305911,9305137,1548
11685,3483699,4,912649,912673,912661,24
11686,3483699,5,17467038,17470213,17468625,3175
11687,3483700,1,4870313,4871395,4870854,1082
11688,3483700,1,16644400,16644602,16644501,202
11689,3483700,1,22996024,22996539,22996281,515
11690,3483700,1,23653311,23653827,23653569,516
11691,3483700,2,384718,386886,385802,2168
11692,3483700,2,6236991,6237302,6237146,311
11693,3483700,3,1627044,1627718,1627381,674
11694,3483700,3,7932528,7933177,7932852,649
11695,3483700,5,3014970,3015920,3015445,950
11696,3483700,5,8948610,8951704,8950157,3094
11697,3483700,5,13894351,13894463,13894407,112
11698,3483701,1,9100273,9100415,9100344,142
11699,3483701,2,1490865,1490901,1490883,36
11700,3483701,2,6033611,6034151,6033881,540
11701,3483701,3,5276150,5276344,5276247,194
11702,3483701,3,8557068,8557632,8557350,564
11703,3483701,3,17201067,17201346,17201206,279
11704,3483701,4,8642145,8643001,8642573,856
11705,3483701,4,10764623,10764655,10764639,32
11706,3483701,5,264290,264742,264516,452
11707,3483701,5,9723133,9723212,9723172,79
11708,3483701,5,17622063,17622883,17622473,820
11709,3483702,1,8912330,8912365,8912347,35
11710,3483702,1,20565838,20566219,20566028,381
11711,3483702,2,1637840,1639955,1638897,2115
11712,3483702,2,14181450,14184854,14183152,3404
11713,3483702,3,5559383,5559812,5559597,429
11714,3483702,3,19987515,19987703,19987609,188
11715,3483702,4,5565022,5565560,5565291,538
11716,3483702,4,7250763,7250928,7250845,165
11717,3483702,5,8194352,8194483,8194417,131
11718,3483702,5,21508095,21508230,21508162,135
11719,3483703,2,7649127,7649292,7649209,165
11720,3483703,3,9713592,9713634,9713613,42
11721,3483703,5,6851266,6852188,6851727,922
11722,3483704,2,6849101,6850123,6849612,1022
11723,3483704,2,14232709,14235208,14233958,2499
11724,3483704,3,19912511,19912525,19912518,14
11725,3483704,4,18008911,18009006,18008958,95
11726,3483704,5,7422658,7422712,7422685,54
11727,3483705,1,8344101,8344436,8344268,335
11728,3483705,1,10656786,10661144,10658965,4358
11729,3483705,2,11501439,11502074,11501756,635
11730,3483705,3,6637420,6639255,6638337,1835
11731,3483705,3,8150786,8150938,8150862,152
11732,3483705,3,9047604,9047798,9047701,194
11733,3483705,3,18116694,18116772,18116733,78
11734,3483705,4,6768148,6768276,6768212,128
11735,3483705,5,761542,761549,761545,7
11736,3483705,5,4565072,4567028,4566050,1956
11737,3483706,1,11665579,11665741,11665660,162
11738,3483706,3,5527214,5527425,5527319,211
11739,3483706,3,19065544,19065963,19065753,419
11740,3483706,4,6950528,6950662,6950595,134
11741,3483706,5,8048585,8048728,8048656,143
11742,3483706,5,14550298,14550961,14550629,663
11743,3483707,1,9973566,9974071,9973818,505
11744,3483707,2,6303782,6304391,6304086,609
11745,3483707,2,7768581,7769226,7768903,645
11746,3483707,2,10611500,10611537,10611518,37
11747,3483707,3,19912374,19912525,19912449,151
11748,3483707,3,23295485,23296658,23296071,1173
11749,3483707,4,1240217,1240867,1240542,650
11750,3483707,5,1103542,1104106,1103824,564
11751,3483707,5,10609655,10609699,10609677,44
11752,3483707,5,18557599,18557635,18557617,36
11753,3483707,5,18976332,18976436,18976384,104
11754,3483708,1,4402197,4404164,4403180,1967
11755,3483708,2,17198028,17198595,17198311,567
11756,3483708,3,15761146,15761204,15761175,58
11757,3483708,4,5337911,5338242,5338076,331
11758,3483709,1,4873250,4873347,4873298,97
11759,3483709,1,17354781,17357506,17356143,2725
11760,3483709,2,298887,302250,300568,3363
11761,3483709,2,856927,858322,857624,1395
11762,3483709,2,7292958,7295608,7294283,2650
11763,3483709,3,949734,951135,950434,1401
11764,3483709,3,18704643,18704749,18704696,106
11765,3483709,4,16423900,16423901,16423900,1
11766,3483709,5,14874246,14874306,14874276,60
11767,3483710,1,7540370,7540910,7540640,540
11768,3483710,1,23562607,23564268,23563437,1661
11769,3483710,1,25212109,25213272,25212690,1163
11770,3483710,2,14071347,14072757,14072052,1410
11771,3483710,3,8021754,8022045,8021899,291
11772,3483710,3,10189945,10189992,10189968,47
11773,3483710,4,971679,972197,971938,518
11774,3483710,4,15965053,15965168,15965110,115
11775,3483710,5,13711213,13750806,13731009,39593
11776,3483711,1,10331208,10334847,10333027,3639
11777,3483711,1,25830749,25831057,25830903,308
11778,3483711,2,18763304,18763686,18763495,382
11779,3483711,3,10859075,10859236,10859155,161
11780,3483711,3,16154175,16154236,16154205,61
11781,3483711,5,17907870,17908213,17908041,343
11782,3483712,1,7780266,7781619,7780942,1353
11783,3483712,1,27106192,27106935,27106563,743
11784,3483712,2,101579,102250,101914,671
11785,3483712,2,15844484,15845465,15844974,981
11786,3483712,2,17980299,17980410,17980354,111
11787,3483712,3,2479813,2480870,2480341,1057
11788,3483712,3,4141096,4145422,4143259,4326
11789,3483712,3,11139333,11139376,11139354,43
11790,3483712,3,18519457,18520396,18519926,939
11791,3483712,3,22099340,22099699,22099519,359
11792,3483712,4,6881640,6882438,6882039,798
11793,3483712,4,10972435,10973055,10972745,620
11794,3483712,5,764523,764809,764666,286
11795,3483712,5,2934996,2935997,2935496,1001
11796,3483712,5,15831826,15831930,15831878,104
11797,3483712,5,22315086,22315218,22315152,132
11798,3483713,1,10582668,10583074,10582871,406
11799,3483713,1,24599043,24599659,24599351,616
11800,3483713,3,1335251,1335417,1335334,166
11801,3483713,3,11302493,11302662,11302577,169
11802,3483713,3,18741756,18742329,18742042,573
11803,3483713,4,718116,718290,718203,174
11804,3483713,4,7339627,7339751,7339689,124
11805,3483713,5,7922359,7922373,7922366,14
11806,3483713,5,9091571,9092100,9091835,529
11807,3483714,1,1288787,1293180,1290983,4393
11808,3483714,1,22017771,22018437,22018104,666
11809,3483714,2,11799774,11800172,11799973,398
11810,3483714,3,1068777,1069706,1069241,929
11811,3483714,3,15360296,15360391,15360343,95
11812,3483714,4,6270306,6270638,6270472,332
11813,3483714,4,12128069,12128272,12128170,203
11814,3483714,5,10814695,10814894,10814794,199
11815,3483715,1,3521992,3522557,3522274,565
11816,3483715,1,4289556,4290013,4289784,457
11817,3483715,1,17602223,17604404,17603313,2181
11818,3483715,1,23359512,23359975,23359743,463
11819,3483715,4,1309390,1309503,1309446,113
11820,3483715,4,6934061,6934066,6934063,5
11821,3483715,5,4807838,4807911,4807874,73
11822,3483715,5,26352208,26352224,26352216,16
11823,3483716,1,7604427,7605328,7604877,901
11824,3483716,1,8870262,8870313,8870287,51
11825,3483716,1,19928828,19928961,19928894,133
11826,3483716,4,302670,303969,303319,1299
11827,3483716,5,20634621,20634754,20634687,133
11828,3483717,2,17163429,17164634,17164031,1205
11829,3483717,3,10153943,10153971,10153957,28
11830,3483717,3,17442527,17442557,17442542,30
11831,3483717,4,1031019,1031358,1031188,339
11832,3483717,4,13217351,13217586,13217468,235
11833,3483717,5,23674897,23676602,23675749,1705
11834,3483718,1,3875710,3877605,3876657,1895
11835,3483718,1,9800316,9800852,9800584,536
11836,3483718,1,22365299,22365804,22365551,505
11837,3483718,2,224081,224871,224476,790
11838,3483718,2,13512709,13512827,13512768,118
11839,3483718,3,8233255,8233800,8233527,545
11840,3483718,3,10590791,10590850,10590820,59
11841,3483718,5,7902859,7902871,7902865,12
11842,3483719,2,11544384,11544415,11544399,31
11843,3483719,3,17331755,17333376,17332565,1621
11844,3483719,3,17333376,17333443,17333409,67
11845,3483720,1,24826543,24830833,24828688,4290
11846,3483720,1,27830862,27831079,27830970,217
11847,3483720,2,12147671,12147709,12147690,38
11848,3483720,2,19007789,19008000,19007894,211
11849,3483720,3,11154315,11154462,11154388,147
11850,3483720,4,853453,853530,853491,77
11851,3483720,5,2092320,2093160,2092740,840
11852,3483721,1,6664379,6664518,6664448,139
11853,3483721,2,7570107,7572000,7571053,1893
11854,3483721,2,17916319,17916844,17916581,525
11855,3483721,3,10706813,10711007,10708910,4194
11856,3483721,3,20752736,20753334,20753035,598
11857,3483721,4,1533596,1533646,1533621,50
11858,3483721,4,6362366,6362444,6362405,78
11859,3483721,4,12136415,12137229,12136822,814
11860,3483721,5,8848091,8848517,8848304,426
11861,3483721,5,17144954,17145346,17145150,392
11862,3483721,5,21455569,21455602,21455585,33
11863,3483722,1,9992264,9992950,9992607,686
11864,3483722,1,24628799,24630452,24629625,1653
11865,3483722,2,6237302,6237380,6237341,78
11866,3483722,2,12276292,12278875,12277583,2583
11867,3483722,4,7590074,7590383,7590228,309
11868,3483722,4,10019416,10021077,10020246,1661
11869,3483723,1,19796260,19796651,19796455,391
11870,3483723,3,3696484,3697470,3696977,986
11871,3483723,3,16522274,16522649,16522461,375
11872,3483723,3,17018219,17021433,17019826,3214
11873,3483723,4,8857358,8857584,8857471,226
11874,3483723,5,1681342,1681513,1681427,171
11875,3483724,1,25063741,25063747,25063744,6
11876,3483724,3,10172250,10172265,10172257,15
11877,3483724,5,13938064,13938345,13938204,281
11878,3483724,5,16227622,16229205,16228413,1583
11879,3483725,2,17779211,17785473,17782342,6262
11880,3483725,3,7108927,7111970,7110448,3043
11881,3483725,3,16256997,16271728,16264362,14731
11882,3483725,3,17023750,17024236,17023993,486
11883,3483725,3,19913438,19915063,19914250,1625
11884,3483725,4,5754990,5755064,5755027,74
11885,3483726,1,18054469,18055223,18054846,754
11886,3483726,1,27180520,27183587,27182053,3067
11887,3483726,2,338959,339203,339081,244
11888,3483726,2,8541036,8541052,8541044,16
11889,3483726,2,17951949,17951995,17951972,46
11890,3483726,3,17425576,17425774,17425675,198
11891,3483726,5,17180004,17180214,17180109,210
11892,3483727,1,8358591,8358831,8358711,240
11893,3483727,1,18239882,18240108,18239995,226
11894,3483727,1,26968945,26968991,26968968,46
11895,3483727,3,3432363,3432928,3432645,565
11896,3483727,3,10332687,10332905,10332796,218
11897,3483727,4,11519729,11520571,11520150,842
11898,3483727,5,2552716,2553497,2553106,781
11899,3483727,5,4198922,4198978,4198950,56
11900,3483728,1,7043910,7045933,7044921,2023
11901,3483728,1,20002249,20002381,20002315,132
11902,3483728,1,29046544,29047894,29047219,1350
11903,3483728,2,1492618,1492710,1492664,92
11904,3483728,3,22004628,22004869,22004748,241
11905,3483728,4,8342548,8344891,8343719,2343
11906,3483728,4,10149915,10150852,10150383,937
11907,3483728,5,255464,255866,255665,402
11908,3483728,5,16946313,16946528,16946420,215
11909,3483728,5,20083993,20084588,20084290,595
11910,3483729,1,16135258,16135421,16135339,163
11911,3483729,1,25612952,25612989,25612970,37
11912,3483729,3,7985589,7987074,7986331,1485
11913,3483729,3,16622423,16622513,16622468,90
11914,3483729,4,5388336,5388794,5388565,458
11915,3483729,5,3048902,3049905,3049403,1003
11916,3483729,5,7123051,7126265,7124658,3214
11917,3483730,1,4472154,4472189,4472171,35
11918,3483730,1,17034847,17051000,17042923,16153
11919,3483730,2,11055639,11056383,11056011,744
11920,3483730,3,7349024,7349115,7349069,91
11921,3483730,3,16831134,16831299,16831216,165
11922,3483730,4,6354810,6354860,6354835,50
11923,3483730,4,17659254,17660259,17659756,1005
11924,3483730,5,877541,878003,877772,462
11925,3483730,5,8737721,8738214,8737967,493
11926,3483730,5,15253878,15254013,15253945,135
11927,3483731,1,7494250,7494294,7494272,44
11928,3483731,2,213845,218572,216208,4727
11929,3483731,2,7577200,7577855,7577527,655
11930,3483731,2,10181225,10182548,10181886,1323
11931,3483731,3,586407,586810,586608,403
11932,3483731,3,7718529,7719108,7718818,579
11933,3483731,3,18532093,18532292,18532192,199
11934,3483731,3,20006825,20006970,20006897,145
11935,3483731,4,5241609,5242077,5241843,468
11936,3483731,5,506803,506887,506845,84
11937,3483731,5,3476872,3476880,3476876,8
11938,3483731,5,17594695,17594794,17594744,99
11939,3483731,5,18499820,18502528,18501174,2708
11940,3483732,1,21353954,21354300,21354127,346
11941,3483732,1,26330784,26331428,26331106,644
11942,3483732,3,5454080,5454177,5454128,97
11943,3483732,4,8897575,8897940,8897757,365
11944,3483732,4,15823798,15827304,15825551,3506
11945,3483733,1,4561925,4563230,4562577,1305
11946,3483733,2,371318,373365,372341,2047
11947,3483733,2,10533585,10533629,10533607,44
11948,3483733,3,10953071,10953322,10953196,251
11949,3483733,4,6228804,6230746,6229775,1942
11950,3483733,5,4835234,4836797,4836015,1563
11951,3483733,5,18185839,18185928,18185883,89
11952,3483733,5,20001472,20001776,20001624,304
11953,3483734,1,5131879,5132391,5132135,512
11954,3483734,1,12532425,12532455,12532440,30
11955,3483734,1,16405700,16405744,16405722,44
11956,3483734,1,29483058,29483748,29483403,690
11957,3483734,2,6242419,6243040,6242729,621
11958,3483734,2,6243040,6244110,6243575,1070
11959,3483734,2,15960597,15960649,15960623,52
11960,3483734,3,6672200,6673441,6672820,1241
11961,3483734,4,305713,306895,306304,1182
11962,3483734,5,6043935,6044020,6043977,85
11963,3483734,5,16191800,16192143,16191971,343
11964,3483735,1,16647986,16648057,16648021,71
11965,3483735,1,25392933,25393221,25393077,288
11966,3483735,2,9604299,9607582,9605940,3283
11967,3483735,3,4331538,4332030,4331784,492
11968,3483735,3,16036372,16036800,16036586,428
11969,3483735,4,387454,390127,388790,2673
11970,3483735,4,9768732,9768827,9768779,95
11971,3483735,5,1817726,1819425,1818575,1699
11972,3483735,5,24251927,24252120,24252023,193
11973,3483736,1,4307369,4307406,4307387,37
11974,3483736,1,11935714,11936615,11936164,901
11975,3483736,1,23998861,23999172,23999016,311
11976,3483736,2,9715834,9716578,9716206,744
11977,3483736,3,1776074,1776477,1776275,403
11978,3483736,3,8137292,8137573,8137432,281
11979,3483736,4,15859785,15859906,15859845,121
11980,3483736,5,8217137,8218493,8217815,1356
11981,3483736,5,23935787,23937228,23936507,1441
11982,3483737,1,28921564,28922256,28921910,692
11983,3483737,2,9979507,9980582,9980044,1075
11984,3483737,3,6478860,6479235,6479047,375
11985,3483737,3,11913040,11913839,11913439,799
11986,3483737,3,15603035,15603503,15603269,468
11987,3483737,4,11007788,11010953,11009370,3165
11988,3483737,5,26568250,26568344,26568297,94
11989,3483738,1,2520048,2520128,2520088,80
11990,3483738,1,22802535,22802681,22802608,146
11991,3483738,1,24495844,24496851,24496347,1007
11992,3483738,1,28355801,28356313,28356057,512
11993,3483738,1,30409553,30409757,30409655,204
11994,3483738,2,10076422,10077001,10076711,579
11995,3483738,3,6216890,6218006,6217448,1116
11996,3483738,3,19626549,19626874,19626711,325
11997,3483738,4,5315342,5315882,5315612,540
11998,3483738,5,2367945,2368057,2368001,112
11999,3483739,1,9812854,9812894,9812874,40
12000,3483739,1,29482990,29483748,29483369,758
12001,3483739,2,11529307,11529607,11529457,300
12002,3483739,3,9982503,9982758,9982630,255
12003,3483739,5,9044516,9045619,9045067,1103
12004,3483739,5,23474745,23475672,23475208,927
12005,3483740,1,2819102,2819549,2819325,447
12006,3483740,1,4542102,4542122,4542112,20
12007,3483740,1,28433951,28436868,28435409,2917
12008,3483740,2,1553919,1554358,1554138,439
12009,3483740,2,17686556,17687000,17686778,444
12010,3483740,4,155872,156431,156151,559
12011,3483740,5,24769429,24770159,24769794,730
12012,3483741,1,9859326,9860916,9860121,1590
12013,3483741,1,10427956,10428325,10428140,369
12014,3483741,2,7820906,7822963,7821934,2057
12015,3483741,2,10083425,10083610,10083517,185
12016,3483741,4,8602194,8604632,8603413,2438
12017,3483741,5,7461802,7462308,7462055,506
12018,3483741,5,19691532,19691613,19691572,81
12019,3483742,1,8187765,8187797,8187781,32
12020,3483742,1,25233085,25233302,25233193,217
12021,3483742,3,7559462,7559691,7559576,229
12022,3483742,3,17547879,17549329,17548604,1450
12023,3483742,3,20619143,20620584,20619863,1441
12024,3483742,4,5143672,5143808,5143740,136
12025,3483742,4,10000741,10001780,10001260,1039
12026,3483742,4,17124227,17125420,17124823,1193
12027,3483742,5,4189090,4190263,4189676,1173
12028,3483742,5,9416727,9416728,9416727,1
12029,3483742,5,25515715,25515992,25515853,277
12030,3483742,5,26059221,26060559,26059890,1338
12031,3483743,1,13077108,13077389,13077248,281
12032,3483743,1,28181538,28182172,28181855,634
12033,3483743,2,2100291,2100416,2100353,125
12034,3483743,3,8497369,8497891,8497630,522
12035,3483743,3,18302585,18302824,18302704,239
12036,3483743,4,11521078,11521774,11521426,696
12037,3483743,5,7243965,7244125,7244045,160
12038,3483743,5,9819761,9821680,9820720,1919
12039,3483743,5,25804395,25804974,25804684,579
12040,3483744,1,4360915,4361059,4360987,144
12041,3483744,1,12343470,12343651,12343560,181
12042,3483744,2,1007543,1007797,1007670,254
12043,3483744,3,18410127,18410555,18410341,428
12044,3483744,4,13832813,13835794,13834303,2981
12045,3483744,5,14648303,14652481,14650392,4178
12046,3483744,5,15214304,15214469,15214386,165
12047,3483744,5,21455400,21455569,21455484,169
12048,3483744,5,25162532,25162835,25162683,303
12049,3483745,1,24388881,24388914,24388897,33
12050,3483745,2,8935421,8935452,8935436,31
12051,3483745,2,18640430,18640700,18640565,270
12052,3483745,2,19048343,19048717,19048530,374
12053,3483745,3,1544880,1545370,1545125,490
12054,3483745,3,14942879,14943258,14943068,379
12055,3483745,4,11705341,11705886,11705613,545
12056,3483745,4,18295835,18296295,18296065,460
12057,3483745,5,1258716,1259321,1259018,605
12058,3483746,1,12956176,12956256,12956216,80
12059,3483746,1,29783698,29784304,29784001,606
12060,3483746,4,175816,176314,176065,498
12061,3483746,4,8099194,8099221,8099207,27
12062,3483746,5,1774068,1776446,1775257,2378
12063,3483746,5,18582830,18585901,18584365,3071
12064,3483747,1,4889209,4889425,4889317,216
12065,3483747,1,24368797,24368836,24368816,39
12066,3483747,2,5648984,5650782,5649883,1798
12067,3483747,2,6285965,6286866,6286415,901
12068,3483747,2,15397625,15398520,15398072,895
12069,3483747,3,22491920,22492050,22491985,130
12070,3483747,5,18878803,18879423,18879113,620
12071,3483748,1,9461452,9462249,9461850,797
12072,3483748,3,21146188,21146384,21146286,196
12073,3483748,4,16498013,16498108,16498060,95
12074,3483748,5,9676159,9676301,9676230,142
12075,3483748,5,15463501,15466448,15464974,2947
12076,3483749,1,5127313,5127398,5127355,85
12077,3483749,1,26654287,26654289,26654288,2
12078,3483749,1,27307346,27309452,27308399,2106
12079,3483749,2,6904221,6904759,6904490,538
12080,3483749,2,11674083,11674125,11674104,42
12081,3483749,3,302598,303169,302883,571
12082,3483749,3,9396404,9398387,9397395,1983
12083,3483749,4,9943973,9944028,9944000,55
12084,3483749,5,18610407,18610774,18610590,367
12085,3483749,5,21765750,21766288,21766019,538
12086,3483750,1,16970797,16970932,16970864,135
12087,3483750,2,2424152,2424387,2424269,235
12088,3483750,2,10217046,10217368,10217207,322
12089,3483750,3,20031317,20032134,20031725,817
12090,3483750,4,653570,653610,653590,40
12091,3483751,1,357629,362193,359911,4564
12092,3483751,1,13983651,13984424,13984037,773
12093,3483751,1,29183103,29183540,29183321,437
12094,3483751,2,9670893,9670986,9670939,93
12095,3483751,2,12595757,12596184,12595970,427
12096,3483751,3,900949,901089,901019,140
12097,3483751,3,11368036,11368221,11368128,185
12098,3483751,4,13988073,13992357,13990215,4284
12099,3483751,5,5717017,5718060,5717538,1043
12100,3483751,5,6977463,6977942,6977702,479
12101,3483751,5,20003325,20003855,20003590,530
12102,3483752,1,13144768,13145626,13145197,858
12103,3483752,1,16024794,16025132,16024963,338
12104,3483752,1,16647325,16647810,16647567,485
12105,3483752,1,18426030,18426350,18426190,320
12106,3483752,1,22982489,22982837,22982663,348
12107,3483752,1,25397048,25400076,25398562,3028
12108,3483752,1,26143440,26143675,26143557,235
12109,3483752,2,99910,99936,99923,26
12110,3483752,2,5322190,5322332,5322261,142
12111,3483752,2,6860552,6860611,6860581,59
12112,3483752,2,7649780,7654825,7652302,5045
12113,3483752,2,8252877,8254632,8253754,1755
12114,3483752,2,8918602,8918760,8918681,158
12115,3483752,2,11166615,11167900,11167257,1285
12116,3483752,3,8920698,8921159,8920928,461
12117,3483752,3,11210960,11211350,11211155,390
12118,3483752,4,6203400,6203422,6203411,22
12119,3483752,4,11675307,11675679,11675493,372
12120,3483752,5,9125325,9125334,9125329,9
12121,3483753,1,6867907,6868764,6868335,857
12122,3483753,1,16148363,16148426,16148394,63
12123,3483753,2,802984,803546,803265,562
12124,3483753,2,10372178,10372418,10372298,240
12125,3483753,2,14727467,14727781,14727624,314
12126,3483753,3,22902335,22902986,22902660,651
12127,3483753,4,18120567,18121479,18121023,912
12128,3483753,5,13749219,13750806,13750012,1587
12129,3483753,5,25761593,25762070,25761831,477
12130,3483754,1,19541292,19541437,19541364,145
12131,3483754,1,20013179,20013232,20013205,53
12132,3483754,1,20496195,20497575,20496885,1380
12133,3483754,1,25806808,25806817,25806812,9
12134,3483754,1,30416501,30416591,30416546,90
12135,3483754,2,14023715,14023823,14023769,108
12136,3483754,3,2525815,2525876,2525845,61
12137,3483754,3,17484558,17484727,17484642,169
12138,3483754,4,7305136,7305192,7305164,56
12139,3483754,4,9392816,9393065,9392940,249
12140,3483754,4,14707366,14707664,14707515,298
12141,3483754,4,17799203,17800053,17799628,850
12142,3483754,5,1932158,1932376,1932267,218
12143,3483755,1,10950920,10951985,10951452,1065
12144,3483755,1,12912929,12913001,12912965,72
12145,3483755,2,2231116,2231274,2231195,158
12146,3483755,2,18493635,18493736,18493685,101
12147,3483755,3,17638075,17638278,17638176,203
12148,3483755,4,1441087,1441275,1441181,188
12149,3483755,4,5147314,5147931,5147622,617
12150,3483755,4,17376705,17377239,17376972,534
12151,3483755,5,61236,63408,62322,2172
12152,3483755,5,26630306,26630727,26630516,421
12153,3483756,1,26240886,26241078,26240982,192
12154,3483756,2,10041198,10041348,10041273,150
12155,3483756,4,10132479,10132685,10132582,206
12156,3483756,4,11399326,11399524,11399425,198
12157,3483756,5,7979855,7980019,7979937,164
12158,3483756,5,21968969,21969915,21969442,946
12159,3483757,1,3021141,3021292,3021216,151
12160,3483757,1,18180239,18181724,18180981,1485
12161,3483757,3,7535172,7535773,7535472,601
12162,3483757,3,11746681,11748041,11747361,1360
12163,3483757,4,560492,560572,560532,80
12164,3483757,4,6291220,6291685,6291452,465
12165,3483757,5,6619840,6619861,6619850,21
12166,3483757,5,20950224,20950669,20950446,445
12167,3483757,5,24982629,24982679,24982654,50
12168,3483758,1,11461604,11461611,11461607,7
12169,3483758,2,7039963,7040107,7040035,144
12170,3483758,3,17089319,17089493,17089406,174
12171,3483758,3,18904550,18904687,18904618,137
12172,3483758,4,924306,924715,924510,409
12173,3483758,4,8871234,8871482,8871358,248
12174,3483758,5,8747438,8747476,8747457,38
12175,3483758,5,15753113,15753484,15753298,371
12176,3483759,1,4131124,4133183,4132153,2059
12177,3483759,1,8530728,8531111,8530919,383
12178,3483759,1,11113812,11116278,11115045,2466
12179,3483759,1,17864468,17865149,17864808,681
12180,3483759,3,1958959,1960320,1959639,1361
12181,3483759,3,9337656,9338252,9337954,596
12182,3483759,3,23290059,23290413,23290236,354
12183,3483759,4,360298,360353,360325,55
12184,3483759,5,17594794,17594898,17594846,104
12185,3483759,5,18367239,18369751,18368495,2512
12186,3483760,1,13095092,13095533,13095312,441
12187,3483760,2,1640307,1640430,1640368,123
12188,3483760,3,5156186,5156322,5156254,136
12189,3483760,3,16548560,16548742,16548651,182
12190,3483760,4,5309225,5309726,5309475,501
12191,3483760,4,9420539,9420556,9420547,17
12192,3483760,5,7738164,7743066,7740615,4902
12193,3483760,5,9434818,9434991,9434904,173
12194,3483760,5,19430207,19431057,19430632,850
12195,3483760,5,26530569,26532250,26531409,1681
12196,3483761,1,11850932,11851125,11851028,193
12197,3483761,1,13159056,13159135,13159095,79
12198,3483761,1,20431467,20431907,20431687,440
12199,3483761,2,9563549,9564274,9563911,725
12200,3483761,2,12781787,12782389,12782088,602
12201,3483761,4,1397528,1398389,1397958,861
12202,3483761,4,8377972,8380345,8379158,2373
12203,3483761,5,9619053,9619835,9619444,782
12204,3483762,1,8173605,8174167,8173886,562
12205,3483762,1,19506833,19507657,19507245,824
12206,3483762,3,7650421,7651279,7650850,858
12207,3483762,3,11047119,11047198,11047158,79
12208,3483762,4,8604836,8608007,8606421,3171
12209,3483763,1,11108609,11108858,11108733,249
12210,3483763,1,12967550,12967588,12967569,38
12211,3483763,2,10536907,10539009,10537958,2102
12212,3483763,2,14535713,14535810,14535761,97
12213,3483763,3,1177533,1177790,1177661,257
12214,3483763,3,15616700,15618231,15617465,1531
12215,3483763,3,17506272,17506498,17506385,226
12216,3483763,4,7592023,7592563,7592293,540
12217,3483763,4,15025272,15025708,15025490,436
12218,3483763,5,2077767,2078052,2077909,285
12219,3483763,5,9990810,9990937,9990873,127
12220,3483763,5,26804379,26804519,26804449,140
12221,3483764,1,4108627,4109833,4109230,1206
12222,3483764,1,6619970,6620119,6620044,149
12223,3483764,2,6802392,6802479,6802435,87
12224,3483764,2,15603774,15613084,15608429,9310
12225,3483764,4,11423973,11426043,11425008,2070
12226,3483764,5,16840757,16840930,16840843,173
12227,3483764,5,17926060,17926353,17926206,293
12228,3483765,1,2403758,2404671,2404214,913
12229,3483765,1,13140606,13140907,13140756,301
12230,3483765,1,28417570,28418016,28417793,446
12231,3483765,2,19244347,19247800,19246073,3453
12232,3483765,3,15076685,15076855,15076770,170
12233,3483765,5,16006490,16006643,16006566,153
12234,3483766,1,9213362,9213916,9213639,554
12235,3483766,1,29870971,29871444,29871207,473
12236,3483766,2,11095697,11096359,11096028,662
12237,3483766,2,19017189,19017227,19017208,38
12238,3483766,3,6230378,6230444,6230411,66
12239,3483766,4,868157,868337,868247,180
12240,3483766,4,10466183,10466399,10466291,216
12241,3483766,5,18703706,18704295,18704000,589
12242,3483767,1,13077108,13077389,13077248,281
12243,3483767,1,19095031,19095565,19095298,534
12244,3483767,1,23402042,23402056,23402049,14
12245,3483767,2,7160242,7160950,7160596,708
12246,3483767,2,19003326,19003436,19003381,110
12247,3483767,3,9971356,9973594,9972475,2238
12248,3483767,3,10215688,10216601,10216144,913
12249,3483767,4,9380468,9380629,9380548,161
12250,3483767,4,12974617,12975435,12975026,818
12251,3483767,5,9208426,9208452,9208439,26
12252,3483767,5,16637517,16638496,16638006,979
12253,3483767,5,17916932,17918003,17917467,1071
12254,3483768,1,1549889,1550351,1550120,462
12255,3483768,1,17572778,17572781,17572779,3
12256,3483768,1,22273029,22273253,22273141,224
12257,3483768,1,26412832,26413843,26413337,1011
12258,3483768,2,529875,531707,530791,1832
12259,3483768,3,6369864,6370168,6370016,304
12260,3483768,3,12655952,12657809,12656880,1857
12261,3483768,3,17748781,17748972,17748876,191
12262,3483769,1,5360991,5361770,5361380,779
12263,3483769,1,13359470,13360031,13359750,561
12264,3483769,3,347372,347621,347496,249
12265,3483769,3,10306909,10307191,10307050,282
12266,3483769,3,15959709,15960044,15959876,335
12267,3483769,4,11354932,11355541,11355236,609
12268,3483770,1,8317429,8317624,8317526,195
12269,3483770,1,17034847,17051000,17042923,16153
12270,3483770,1,28251716,28252083,28251899,367
12271,3483770,2,232781,233250,233015,469
12272,3483770,2,18120348,18121004,18120676,656
12273,3483770,3,3654285,3654322,3654303,37
12274,3483770,3,19201045,19201582,19201313,537
12275,3483770,4,718207,718290,718248,83
12276,3483770,4,1023562,1026302,1024932,2740
12277,3483770,4,17902095,17902357,17902226,262
12278,3483770,5,6597894,6601284,6599589,3390
12279,3483770,5,7230701,7230849,7230775,148
12280,3483771,1,8451197,8451300,8451248,103
12281,3483771,1,11817091,11817164,11817127,73
12282,3483771,1,16141093,16141442,16141267,349
12283,3483771,1,24632979,24633088,24633033,109
12284,3483771,2,6017200,6018166,6017683,966
12285,3483771,3,11303080,11303185,11303132,105
12286,3483771,4,461755,461978,461866,223
12287,3483771,5,7429717,7430033,7429875,316
12288,3483771,5,7727926,7727942,7727934,16
12289,3483771,5,17125855,17125885,17125870,30
12290,3483771,5,26241434,26243623,26242528,2189
12291,3483772,1,15994325,15994571,15994448,246
12292,3483772,2,1906684,1906763,1906723,79
12293,3483772,2,19255757,19256567,19256162,810
12294,3483772,3,19631710,19631913,19631811,203
12295,3483772,5,9687949,9689170,9688559,1221
12296,3483773,1,3892940,3894207,3893573,1267
12297,3483773,1,12936263,12936313,12936288,50
12298,3483773,1,18774710,18776595,18775652,1885
12299,3483773,3,7968069,7968489,7968279,420
12300,3483773,3,11815879,11818614,11817246,2735
12301,3483773,4,11937844,11937880,11937862,36
12302,3483773,5,8983732,8985653,8984692,1921
12303,3483773,5,14103305,14105415,14104360,2110
12304,3483774,1,16898932,16899196,16899064,264
12305,3483774,1,25975634,25978107,25976870,2473
12306,3483774,2,6537537,6538133,6537835,596
12307,3483774,2,14376342,14376555,14376448,213
12308,3483774,3,5429665,5429800,5429732,135
12309,3483774,3,7036804,7036979,7036891,175
12310,3483774,3,20443529,20443593,20443561,64
12311,3483774,4,5430272,5430330,5430301,58
12312,3483774,5,26587116,26587956,26587536,840
12313,3483775,1,9896116,9896702,9896409,586
12314,3483775,2,6540748,6541927,6541337,1179
12315,3483775,3,9853874,9854022,9853948,148
12316,3483775,4,6062839,6062869,6062854,30
12317,3483775,4,16969437,16969744,16969590,307
12318,3483776,1,10895213,10895576,10895394,363
12319,3483776,1,29772504,29772622,29772563,118
12320,3483776,2,835752,836067,835909,315
12321,3483776,2,7237444,7237766,7237605,322
12322,3483776,2,12529276,12530282,12529779,1006
12323,3483776,4,302670,303969,303319,1299
12324,3483776,4,7296913,7297166,7297039,253
12325,3483776,5,8762371,8764202,8763286,1831
12326,3483776,5,18132785,18132797,18132791,12
12327,3483776,5,21318184,21318748,21318466,564
12328,3483776,5,21320395,21320418,21320406,23
12329,3483776,5,26514283,26514474,26514378,191
12330,3483776,5,26515206,26515551,26515378,345
12331,3483777,1,8187765,8187797,8187781,32
12332,3483777,1,20724919,20725095,20725007,176
12333,3483777,3,4757619,4762295,4759957,4676
12334,3483777,3,11725018,11729924,11727471,4906
12335,3483777,5,9064070,9064444,9064257,374
12336,3483778,1,570157,571284,570720,1127
12337,3483778,1,11794778,11794968,11794873,190
12338,3483778,1,26909973,26910129,26910051,156
12339,3483778,2,7111535,7113094,7112314,1559
12340,3483778,2,15024681,15028942,15026811,4261
12341,3483778,3,4338392,4339858,4339125,1466
12342,3483778,3,10506670,10506694,10506682,24
12343,3483778,3,16618791,16621609,16620200,2818
12344,3483778,4,731447,732634,732040,1187
12345,3483778,4,10263788,10264267,10264027,479
12346,3483778,5,14092283,14092593,14092438,310
12347,3483778,5,17851943,17853639,17852791,1696
12348,3483779,1,1433637,1433784,1433710,147
12349,3483779,1,12706590,12707772,12707181,1182
12350,3483779,1,12972141,12972500,12972320,359
12351,3483779,3,7784686,7785022,7784854,336
12352,3483779,3,17912903,17913572,17913237,669
12353,3483779,5,8780533,8780759,8780646,226
12354,3483780,1,12502103,12504455,12503279,2352
12355,3483780,2,1581595,1583312,1582453,1717
12356,3483780,2,18599788,18599987,18599887,199
12357,3483780,4,6832334,6832436,6832385,102
12358,3483780,4,17006348,17007688,17007018,1340
12359,3483781,1,642802,643447,643124,645
12360,3483781,1,11798809,11800727,11799768,1918
12361,3483781,2,2334712,2334792,2334752,80
12362,3483781,4,11416074,11417214,11416644,1140
12363,3483781,5,13364685,13365703,13365194,1018
12364,3483781,5,17825157,17825277,17825217,120
12365,3483782,1,4290013,4290559,4290286,546
12366,3483782,1,23953261,23953855,23953558,594
12367,3483782,1,29201989,29202119,29202054,130
12368,3483782,2,6018173,6018933,6018553,760
12369,3483782,3,884989,885164,885076,175
12370,3483782,3,11050585,11050685,11050635,100
12371,3483782,3,11384466,11386245,11385355,1779
12372,3483782,4,8438956,8440513,8439734,1557
12373,3483782,5,1974885,1975981,1975433,1096
12374,3483782,5,18893682,18894884,18894283,1202
12375,3483783,1,8284248,8284888,8284568,640
12376,3483783,1,26425855,26426146,26426000,291
12377,3483783,2,9529916,9533313,9531614,3397
12378,3483783,2,9952630,9953242,9952936,612
12379,3483783,2,12186603,12188456,12187529,1853
12380,3483783,3,10952006,10952335,10952170,329
12381,3483783,5,21141212,21141522,21141367,310
12382,3483784,1,8534937,8536527,8535732,1590
12383,3483784,1,16711336,16711465,16711400,129
12384,3483784,1,25408566,25409585,25409075,1019
12385,3483784,1,26836574,26836903,26836738,329
12386,3483784,2,88537,91204,89870,2667
12387,3483784,2,495253,496309,495781,1056
12388,3483784,2,19356431,19361198,19358814,4767
12389,3483784,3,3862181,3862256,3862218,75
12390,3483784,3,15903802,15906538,15905170,2736
12391,3483784,4,5507523,5508442,5507982,919
12392,3483784,5,2650074,2653138,2651606,3064
12393,3483784,5,26676793,26678489,26677641,1696
12394,3483785,1,6730931,6731387,6731159,456
12395,3483785,2,1637472,1637516,1637494,44
12396,3483785,2,8059208,8059771,8059489,563
12397,3483785,2,12409525,12409797,12409661,272
12398,3483785,3,6480569,6482390,6481479,1821
12399,3483785,3,8950183,8951535,8950859,1352
12400,3483785,3,23157867,23157979,23157923,112
12401,3483785,4,1464643,1465100,1464871,457
12402,3483785,5,25448167,25449133,25448650,966
12403,3483786,1,5325747,5327650,5326698,1903
12404,3483786,1,17716816,17717265,17717040,449
12405,3483786,1,24359056,24359665,24359360,609
12406,3483786,2,17581634,17582554,17582094,920
12407,3483786,3,12100791,12100806,12100798,15
12408,3483786,4,644179,644758,644468,579
12409,3483786,5,3403310,3403651,3403480,341
12410,3483786,5,3841919,3842696,3842307,777
12411,3483787,1,17062455,17062820,17062637,365
12412,3483787,2,10318601,10319069,10318835,468
12413,3483787,3,2439024,2439723,2439373,699
12414,3483787,3,17562633,17563101,17562867,468
12415,3483787,3,19175855,19175926,19175890,71
12416,3483788,1,6791491,6791617,6791554,126
12417,3483788,1,12496965,12497387,12497176,422
12418,3483788,1,24354268,24354891,24354579,623
12419,3483788,2,7255221,7255778,7255499,557
12420,3483788,3,4805225,4806143,4805684,918
12421,3483788,3,12693554,12693731,12693642,177
12422,3483788,3,14838371,14839144,14838757,773
12423,3483788,3,19612151,19612657,19612404,506
12424,3483788,4,9740504,9740617,9740560,113
12425,3483788,5,5838221,5838637,5838429,416
12426,3483788,5,19204660,19205376,19205018,716
12427,3483788,5,26102879,26105372,26104125,2493
12428,3483789,1,10448456,10448560,10448508,104
12429,3483789,2,1469676,1469903,1469789,227
12430,3483789,2,6294557,6296873,6295715,2316
12431,3483789,2,9735926,9736146,9736036,220
12432,3483789,4,8896158,8896292,8896225,134
12433,3483789,5,7891086,7892068,7891577,982
12434,3483789,5,24407274,24407631,24407452,357
12435,3483790,1,8958719,8958998,8958858,279
12436,3483790,1,8964552,8964684,8964618,132
12437,3483790,1,24988012,24988032,24988022,20
12438,3483790,2,746043,746098,746070,55
12439,3483790,2,4804770,4806437,4805603,1667
12440,3483790,4,6294973,6295201,6295087,228
12441,3483790,4,6326002,6327004,6326503,1002
12442,3483790,5,7847201,7848355,7847778,1154
12443,3483790,5,21159245,21160307,21159776,1062
12444,3483790,5,21327348,21327431,21327389,83
12445,3483791,1,2229697,2231205,2230451,1508
12446,3483791,2,12345707,12347178,12346442,1471
12447,3483791,4,5292339,5292451,5292395,112
12448,3483791,4,14901233,14901498,14901365,265
12449,3483792,1,1545525,1547573,1546549,2048
12450,3483792,1,7789705,7789730,7789717,25
12451,3483792,2,4806168,4806175,4806171,7
12452,3483792,2,9669229,9669422,9669325,193
12453,3483792,2,19205183,19205320,19205251,137
12454,3483792,4,202156,202361,202258,205
12455,3483792,4,525344,525465,525404,121
12456,3483792,5,1241103,1241462,1241282,359
12457,3483792,5,13475160,13475662,13475411,502
12458,3483792,5,14916386,14918533,14917459,2147
12459,3483792,5,25967683,25967700,25967691,17
12460,3483793,1,29785634,29786336,29785985,702
12461,3483793,2,2086411,2089521,2087966,3110
12462,3483793,3,9710819,9711233,9711026,414
12463,3483793,3,22790819,22791165,22790992,346
12464,3483793,4,5370948,5371919,5371433,971
12465,3483793,5,955071,955415,955243,344
12466,3483793,5,23312159,23315417,23313788,3258
12467,3483794,1,7733272,7734101,7733686,829
12468,3483794,1,12734907,12734970,12734938,63
12469,3483794,1,26376744,26377979,26377361,1235
12470,3483794,2,1008190,1008448,1008319,258
12471,3483794,2,18080660,18081036,18080848,376
12472,3483794,4,1248174,1248356,1248265,182
12473,3483794,4,7493969,7494051,7494010,82
12474,3483794,4,16699209,16699778,16699493,569
12475,3483794,5,1417821,1418540,1418180,719
12476,3483794,5,10263147,10263235,10263191,88
12477,3483795,1,6651967,6652493,6652230,526
12478,3483795,1,10912175,10912579,10912377,404
12479,3483795,1,20259997,20267183,20263590,7186
12480,3483795,2,10336473,10338910,10337691,2437
12481,3483795,3,15333965,15334425,15334195,460
12482,3483795,4,12455837,12455952,12455894,115
12483,3483795,4,16322184,16322323,16322253,139
12484,3483795,5,21605963,21606734,21606348,771
12485,3483796,1,12163394,12164711,12164052,1317
12486,3483796,3,4361303,4361427,4361365,124
12487,3483796,3,8533235,8533768,8533501,533
12488,3483796,5,21111077,21111412,21111244,335
12489,3483797,1,18089235,18089388,18089311,153
12490,3483797,1,24895713,24895798,24895755,85
12491,3483797,2,1073245,1073287,1073266,42
12492,3483797,2,1870942,1871886,1871414,944
12493,3483797,3,8684319,8685299,8684809,980
12494,3483797,4,5247995,5248855,5248425,860
12495,3483797,5,1948687,1949249,1948968,562
12496,3483797,5,16406252,16406362,16406307,110
12497,3483797,5,21309832,21309953,21309892,121
12498,3483798,1,4291206,4291941,4291573,735
12499,3483798,1,22601608,22602253,22601930,645
12500,3483798,3,1066148,1066827,1066487,679
12501,3483798,3,9901568,9901887,9901727,319
12502,3483798,4,15922140,15922279,15922209,139
12503,3483798,5,18043385,18044675,18044030,1290
12504,3483799,1,2625960,2626307,2626133,347
12505,3483799,1,4614299,4614354,4614326,55
12506,3483799,1,20159040,20160641,20159840,1601
12507,3483799,2,7367463,7367861,7367662,398
12508,3483799,2,14815435,14821052,14818243,5617
12509,3483799,4,6219392,6219679,6219535,287
12510,3483799,5,15547680,15547789,15547734,109
12511,3483799,5,16032794,16032907,16032850,113
12512,3483800,1,21723976,21724197,21724086,221
12513,3483800,2,10574014,10576322,10575168,2308
12514,3483800,3,545317,545320,545318,3
12515,3483800,3,10844862,10845406,10845134,544
12516,3483800,4,17746662,17746740,17746701,78
12517,3483800,5,13934297,13934298,13934297,1
12518,3483800,5,15887246,15887386,15887316,140
12519,3483801,1,6100558,6100758,6100658,200
12520,3483801,1,11216157,11216496,11216326,339
12521,3483801,1,30173485,30173674,30173579,189
12522,3483801,3,14764699,14764974,14764836,275
12523,3483801,4,262437,262466,262451,29
12524,3483801,5,2420497,2420516,2420506,19
12525,3483802,1,9937542,9937649,9937595,107
12526,3483802,1,29970074,29971884,29970979,1810
12527,3483802,2,18078318,18079816,18079067,1498
12528,3483802,3,764389,764754,764571,365
12529,3483802,3,22813808,22813820,22813814,12
12530,3483802,4,713958,715974,714966,2016
12531,3483802,4,5700866,5700959,5700912,93
12532,3483802,5,21120143,21120169,21120156,26
12533,3483803,1,25932225,25932516,25932370,291
12534,3483803,2,2294998,2295363,2295180,365
12535,3483803,3,10139633,10139645,10139639,12
12536,3483803,4,1016879,1021755,1019317,4876
12537,3483803,4,5315940,5316057,5315998,117
12538,3483803,4,10359553,10359713,10359633,160
12539,3483803,5,13867572,13867967,13867769,395
12540,3483804,1,556164,562860,559512,6696
12541,3483804,1,6000509,6001460,6000984,951
12542,3483804,1,8970523,8970919,8970721,396
12543,3483804,1,24869354,24870276,24869815,922
12544,3483804,2,1535905,1536065,1535985,160
12545,3483804,2,12836474,12838028,12837251,1554
12546,3483804,3,1290533,1290670,1290601,137
12547,3483804,3,11415234,11415345,11415289,111
12548,3483804,4,5315940,5316057,5315998,117
12549,3483804,5,9871592,9871755,9871673,163
12550,3483804,5,22969819,22971650,22970734,1831
12551,3483805,1,19747238,19748561,19747899,1323
12552,3483805,3,6404652,6405342,6404997,690
12553,3483805,4,16186841,16190929,16188885,4088
12554,3483805,5,17570446,17570578,17570512,132
12555,3483806,1,20556995,20561483,20559239,4488
12556,3483806,1,21668239,21668255,21668247,16
12557,3483806,1,29501745,29503066,29502405,1321
12558,3483806,2,7922068,7922113,7922090,45
12559,3483806,2,11910625,11910792,11910708,167
12560,3483806,3,16018219,16018361,16018290,142
12561,3483806,4,11509788,11510104,11509946,316
12562,3483806,4,17325353,17325462,17325407,109
12563,3483806,5,832185,832216,832200,31
12564,3483807,1,28253990,28254972,28254481,982
12565,3483807,2,12145328,12146480,12145904,1152
12566,3483807,3,18511758,18511973,18511865,215
12567,3483807,4,943394,943547,943470,153
12568,3483807,4,11732989,11733885,11733437,896
12569,3483807,4,14308076,14308323,14308199,247
12570,3483807,5,3516258,3517590,3516924,1332
12571,3483808,1,1135459,1135862,1135660,403
12572,3483808,1,19549105,19549309,19549207,204
12573,3483808,2,1494152,1494368,1494260,216
12574,3483808,2,8418502,8418608,8418555,106
12575,3483808,2,18454806,18455147,18454976,341
12576,3483808,3,7457879,7457912,7457895,33
12577,3483808,4,10354645,10356348,10355496,1703
12578,3483808,5,7678243,7678604,7678423,361
12579,3483809,1,22314884,22315532,22315208,648
12580,3483809,1,24773717,24774867,24774292,1150
12581,3483809,2,2205882,2205932,2205907,50
12582,3483809,2,15570737,15570756,15570746,19
12583,3483809,3,17905381,17905901,17905641,520
12584,3483809,4,7533125,7533356,7533240,231
12585,3483809,4,10754086,10754598,10754342,512
12586,3483809,5,7873418,7873610,7873514,192
12587,3483809,5,16817954,16819462,16818708,1508
12588,3483810,1,8339797,8340499,8340148,702
12589,3483810,1,17942688,17942763,17942725,75
12590,3483810,2,16272391,16272456,16272423,65
12591,3483810,5,2171491,2171554,2171522,63
12592,3483810,5,7975473,7975981,7975727,508
12593,3483810,5,26689867,26689878,26689872,11
12594,3483811,1,179753,180812,180282,1059
12595,3483811,1,7954049,7954809,7954429,760
12596,3483811,1,20998714,20999282,20998998,568
12597,3483811,2,10072116,10072988,10072552,872
12598,3483811,3,8899287,8900334,8899810,1047
12599,3483811,5,4128808,4129546,4129177,738
12600,3483811,5,6193393,6193960,6193676,567
12601,3483812,1,6632320,6634009,6633164,1689
12602,3483812,1,23021921,23021953,23021937,32
12603,3483812,2,9149629,9149839,9149734,210
12604,3483812,2,18340693,18341054,18340873,361
12605,3483812,3,4497427,4500007,4498717,2580
12606,3483812,3,20383526,20385377,20384451,1851
12607,3483812,3,20674237,20675566,20674901,1329
12608,3483812,4,17799975,17800053,17800014,78
12609,3483812,5,176445,178351,177398,1906
12610,3483812,5,9056810,9056904,9056857,94
12611,3483813,1,11263138,11263255,11263196,117
12612,3483813,1,28426913,28431833,28429373,4920
12613,3483813,2,835752,836067,835909,315
12614,3483813,3,1353218,1353868,1353543,650
12615,3483813,3,5957027,5958846,5957936,1819
12616,3483813,4,655165,655269,655217,104
12617,3483813,4,7337476,7337793,7337634,317
12618,3483813,4,11456011,11456346,11456178,335
12619,3483813,5,5260896,5262676,5261786,1780
12620,3483813,5,8275853,8276562,8276207,709
12621,3483813,5,19502257,19502742,19502499,485
12622,3483814,1,4165272,4165357,4165314,85
12623,3483814,1,24619417,24620254,24619835,837
12624,3483814,1,29078562,29079507,29079034,945
12625,3483814,2,856157,856267,856212,110
12626,3483814,2,16441198,16441582,16441390,384
12627,3483814,3,8040733,8041297,8041015,564
12628,3483814,3,16127136,16127141,16127138,5
12629,3483814,4,6359147,6359224,6359185,77
12630,3483814,4,6423560,6423584,6423572,24
12631,3483814,5,6110057,6111138,6110597,1081
12632,3483815,1,23779191,23779868,23779529,677
12633,3483815,1,26561367,26561481,26561424,114
12634,3483815,2,9562252,9562467,9562359,215
12635,3483815,3,16648622,16648643,16648632,21
12636,3483815,4,11253161,11254985,11254073,1824
12637,3483815,5,26691656,26691779,26691717,123
12638,3483816,1,17268701,17269252,17268976,551
12639,3483816,1,27497339,27497758,27497548,419
12640,3483816,2,660324,660952,660638,628
12641,3483816,3,10502244,10502321,10502282,77
12642,3483816,3,10709951,10711007,10710479,1056
12643,3483816,3,20274282,20274826,20274554,544
12644,3483816,4,349533,349894,349713,361
12645,3483816,4,17466311,17467919,17467115,1608
12646,3483816,5,26244984,26247606,26246295,2622
12647,3483817,1,4873347,4874819,4874083,1472
12648,3483817,1,6723632,6723763,6723697,131
12649,3483817,1,22004887,22005169,22005028,282
12650,3483817,2,12399503,12399616,12399559,113
12651,3483817,3,7539014,7539532,7539273,518
12652,3483817,4,7754098,7754759,7754428,661
12653,3483817,5,4237377,4238639,4238008,1262
12654,3483817,5,17994859,17994938,17994898,79
12655,3483818,1,7481472,7481917,7481694,445
12656,3483818,1,17091774,17091987,17091880,213
12657,3483818,1,21459643,21460341,21459992,698
12658,3483818,1,24430599,24430926,24430762,327
12659,3483818,2,15011517,15011849,15011683,332
12660,3483818,3,15616063,15616129,15616096,66
12661,3483818,3,16870815,16873298,16872056,2483
12662,3483818,3,16882132,16882245,16882188,113
12663,3483818,5,14619095,14619756,14619425,661
12664,3483818,5,26583787,26584339,26584063,552
12665,3483819,1,24370575,24370634,24370604,59
12666,3483819,2,1364552,1364629,1364590,77
12667,3483819,2,11047571,11049329,11048450,1758
12668,3483819,2,16752549,16752552,16752550,3
12669,3483819,3,20433725,20433779,20433752,54
12670,3483819,4,17689016,17689045,17689030,29
12671,3483820,1,30416928,30416933,30416930,5
12672,3483820,3,956020,956280,956150,260
12673,3483820,3,10720497,10720581,10720539,84
12674,3483820,3,11744694,11744926,11744810,232
12675,3483820,4,5371966,5372087,5372026,121
12676,3483820,4,5705926,5706634,5706280,708
12677,3483820,5,23612482,23612717,23612599,235
12678,3483821,1,20405267,20405820,20405543,553
12679,3483821,1,26221622,26221734,26221678,112
12680,3483821,1,27975915,27976124,27976019,209
12681,3483821,2,1866520,1867137,1866828,617
12682,3483821,2,2100326,2100416,2100371,90
12683,3483821,3,5621730,5624697,5623213,2967
12684,3483821,3,7128439,7128598,7128518,159
12685,3483821,3,19701934,19701950,19701942,16
12686,3483821,4,1243439,1243545,1243492,106
12687,3483821,4,17716345,17717039,17716692,694
12688,3483821,5,4009882,4010648,4010265,766
12689,3483821,5,16629117,16629787,16629452,670
12690,3483821,5,16929390,16929546,16929468,156
12691,3483822,1,8373056,8373379,8373217,323
12692,3483822,2,11477744,11478134,11477939,390
12693,3483822,3,4777349,4777803,4777576,454
12694,3483822,5,1417550,1417648,1417599,98
12695,3483822,5,14241769,14241777,14241773,8
12696,3483823,1,17299274,17299572,17299423,298
12697,3483823,2,6496407,6496463,6496435,56
12698,3483823,3,4540581,4540766,4540673,185
12699,3483823,3,11155371,11156128,11155749,757
12700,3483824,1,12658400,12658541,12658470,141
12701,3483824,1,13078940,13079346,13079143,406
12702,3483824,1,28835713,28837455,28836584,1742
12703,3483824,2,1960303,1960309,1960306,6
12704,3483824,2,12147778,12148121,12147949,343
12705,3483824,2,17972265,17972381,17972323,116
12706,3483824,3,1030382,1030495,1030438,113
12707,3483824,4,1022193,1022202,1022197,9
12708,3483824,5,16066292,16066829,16066560,537
12709,3483825,1,4377533,4378347,4377940,814
12710,3483825,1,9334730,9335239,9334984,509
12711,3483825,1,23977472,23979566,23978519,2094
12712,3483825,2,1563204,1564034,1563619,830
12713,3483825,2,10346534,10346781,10346657,247
12714,3483825,3,682212,685110,683661,2898
12715,3483825,3,20314301,20315010,20314655,709
12716,3483825,4,6989617,6989736,6989676,119
12717,3483825,4,17445023,17445373,17445198,350
12718,3483825,5,3672972,3673176,3673074,204
12719,3483825,5,5041792,5041906,5041849,114
12720,3483825,5,18557482,18557525,18557503,43
12721,3483826,1,17061275,17062455,17061865,1180
12722,3483826,1,25617255,25617612,25617433,357
12723,3483826,3,11382249,11382618,11382433,369
12724,3483826,5,9659818,9659892,9659855,74
12725,3483827,1,613814,614273,614043,459
12726,3483827,1,8452981,8453056,8453018,75
12727,3483827,1,10266880,10267038,10266959,158
12728,3483827,2,2222548,2222865,2222706,317
12729,3483827,2,11580239,11580533,11580386,294
12730,3483827,3,1623952,1624155,1624053,203
12731,3483827,3,2340383,2340421,2340402,38
12732,3483827,3,15412569,15412714,15412641,145
12733,3483827,5,8050843,8051707,8051275,864
12734,3483827,5,15471301,15471970,15471635,669
12735,3483827,5,24066282,24067122,24066702,840
12736,3483828,1,7756594,7757278,7756936,684
12737,3483828,2,19417549,19417949,19417749,400
12738,3483828,3,9070013,9070430,9070221,417
12739,3483828,3,21021136,21021472,21021304,336
12740,3483828,4,17237220,17238346,17237783,1126
12741,3483829,1,17287683,17287788,17287735,105
12742,3483829,1,26541685,26541693,26541689,8
12743,3483829,4,8628878,8628937,8628907,59
12744,3483829,5,5446043,5447099,5446571,1056
12745,3483830,1,3556393,3557358,3556875,965
12746,3483830,2,2471052,2471064,2471058,12
12747,3483830,3,10033467,10034558,10034012,1091
12748,3483830,3,16200893,16201185,16201039,292
12749,3483830,3,19471025,19471322,19471173,297
12750,3483830,4,727590,727784,727687,194
12751,3483830,4,17179089,17182386,17180737,3297
12752,3483830,5,18571003,18573101,18572052,2098
12753,3483831,1,22272151,22272265,22272208,114
12754,3483831,1,29255461,29256259,29255860,798
12755,3483831,2,9233403,9233712,9233557,309
12756,3483831,2,18340693,18341054,18340873,361
12757,3483831,3,1354858,1355404,1355131,546
12758,3483831,4,8020012,8020018,8020015,6
12759,3483831,4,18030229,18031003,18030616,774
12760,3483831,5,13195275,13195346,13195310,71
12761,3483832,2,5542733,5543149,5542941,416
12762,3483832,3,3648550,3649380,3648965,830
12763,3483832,3,12331660,12331814,12331737,154
12764,3483832,3,18850526,18851146,18850836,620
12765,3483832,4,7879527,7880013,7879770,486
12766,3483832,4,10748992,10749446,10749219,454
12767,3483833,1,18718571,18719076,18718823,505
12768,3483833,2,8194741,8197211,8195976,2470
12769,3483833,2,9530089,9530141,9530115,52
12770,3483833,3,7381975,7382029,7382002,54
12771,3483833,3,17920935,17921420,17921177,485
12772,3483833,4,5754628,5754849,5754738,221
12773,3483833,4,11422389,11423106,11422747,717
12774,3483833,5,10291394,10291541,10291467,147
12775,3483834,1,24618127,24618421,24618274,294
12776,3483834,2,7766802,7769226,7768014,2424
12777,3483834,3,15400172,15400181,15400176,9
12778,3483834,3,19898995,19899736,19899365,741
12779,3483834,4,7636775,7637091,7636933,316
12780,3483834,4,16913900,16914138,16914019,238
12781,3483834,5,8180909,8182022,8181465,1113
12782,3483834,5,14902158,14902213,14902185,55
12783,3483834,5,26035526,26036137,26035831,611
12784,3483835,1,24616932,24617653,24617292,721
12785,3483835,2,7769876,7770256,7770066,380
12786,3483835,3,15400478,15400576,15400527,98
12787,3483835,3,19912037,19912374,19912205,337
12788,3483835,4,7635543,7635589,7635566,46
12789,3483835,4,16919784,16920255,16920019,471
12790,3483835,5,8218354,8218493,8218423,139
12791,3483835,5,14899410,14899551,14899480,141
12792,3483835,5,26028237,26028311,26028274,74
12793,3483836,1,13280280,13280819,13280549,539
12794,3483836,1,24646533,24646595,24646564,62
12795,3483836,3,4981963,4982018,4981990,55
12796,3483836,3,9492805,9493114,9492959,309
12797,3483836,5,5811762,5811947,5811854,185
12798,3483837,1,19917540,19918442,19917991,902
12799,3483837,1,25607834,25608726,25608280,892
12800,3483837,2,9361112,9362458,9361785,1346
12801,3483837,3,4061501,4062525,4062013,1024
12802,3483837,3,9920993,9921619,9921306,626
12803,3483837,3,21005786,21008547,21007166,2761
12804,3483837,4,9837604,9838102,9837853,498
12805,3483837,4,10732494,10733550,10733022,1056
12806,3483837,5,774615,774729,774672,114
12807,3483837,5,8044129,8044192,8044160,63
12808,3483838,1,3317106,3317308,3317207,202
12809,3483838,1,10874031,10874257,10874144,226
12810,3483838,1,21014735,21015234,21014984,499
12811,3483838,3,15870698,15870737,15870717,39
12812,3483838,4,784080,785671,784875,1591
12813,3483838,5,26841630,26841789,26841709,159
12814,3483839,1,9094514,9094728,9094621,214
12815,3483839,1,16078610,16078647,16078628,37
12816,3483839,2,653472,653669,653570,197
12817,3483839,3,11100901,11101162,11101031,261
12818,3483839,3,17282013,17282156,17282084,143
12819,3483839,4,5444448,5444551,5444499,103
12820,3483839,5,10461813,10461844,10461828,31
12821,3483840,1,10573066,10576492,10574779,3426
12822,3483840,1,28941603,28942080,28941841,477
12823,3483840,3,9769482,9769603,9769542,121
12824,3483841,1,12254810,12255183,12254996,373
12825,3483841,1,18875303,18875495,18875399,192
12826,3483841,1,26930992,26931867,26931429,875
12827,3483841,2,357398,357844,357621,446
12828,3483841,3,5532828,5533091,5532959,263
12829,3483841,4,9139076,9139213,9139144,137
12830,3483841,5,13865992,13866410,13866201,418
12831,3483842,1,5388729,5388853,5388791,124
12832,3483842,1,18774710,18776595,18775652,1885
12833,3483842,1,29232758,29233214,29232986,456
12834,3483842,2,7292161,7292293,7292227,132
12835,3483842,2,10219901,10220887,10220394,986
12836,3483842,3,9680750,9681728,9681239,978
12837,3483842,3,15968949,15969504,15969226,555
12838,3483842,5,8780910,8780967,8780938,57
12839,3483843,1,4038857,4039902,4039379,1045
12840,3483843,2,9908844,9908885,9908864,41
12841,3483843,2,16758925,16759074,16758999,149
12842,3483843,2,17867843,17869302,17868572,1459
12843,3483843,4,5247995,5248855,5248425,860
12844,3483843,4,6892021,6892359,6892190,338
12845,3483843,5,13428478,13428526,13428502,48
12846,3483844,1,21765343,21765354,21765348,11
12847,3483844,2,360576,365116,362846,4540
12848,3483844,2,1491673,1492710,1492191,1037
12849,3483844,3,20023902,20025181,20024541,1279
12850,3483844,4,82555,82605,82580,50
12851,3483844,4,5578711,5579123,5578917,412
12852,3483844,5,9578927,9579231,9579079,304
12853,3483845,1,5809522,5810167,5809844,645
12854,3483845,1,12397426,12397429,12397427,3
12855,3483845,1,19425712,19425821,19425766,109
12856,3483845,2,661709,661989,661849,280
12857,3483845,2,13146432,13146918,13146675,486
12858,3483845,3,11073398,11073424,11073411,26
12859,3483845,3,19563316,19563349,19563332,33
12860,3483845,4,5377175,5378586,5377880,1411
12861,3483845,4,17443995,17444121,17444058,126
12862,3483845,5,737384,737541,737462,157
12863,3483845,5,13882391,13882405,13882398,14
12864,3483846,1,7102735,7103506,7103120,771
12865,3483846,1,12390399,12390527,12390463,128
12866,3483846,1,24101885,24102828,24102356,943
12867,3483846,1,29521402,29521467,29521434,65
12868,3483846,2,412755,412835,412795,80
12869,3483846,2,17552234,17552674,17552454,440
12870,3483846,3,993246,993775,993510,529
12871,3483846,3,17156432,17159316,17157874,2884
12872,3483846,4,10338931,10339221,10339076,290
12873,3483846,4,12628995,12629230,12629112,235
12874,3483846,5,10277590,10277679,10277634,89
12875,3483847,1,1456863,1457806,1457334,943
12876,3483847,1,19005336,19007991,19006663,2655
12877,3483847,2,2100749,2100773,2100761,24
12878,3483847,3,17953311,17953424,17953367,113
12879,3483847,4,7798516,7799174,7798845,658
12880,3483847,5,3380855,3380938,3380896,83
12881,3483847,5,8834800,8834913,8834856,113
12882,3483848,1,17859705,17859914,17859809,209
12883,3483848,2,9857743,9859106,9858424,1363
12884,3483848,4,14208440,14208731,14208585,291
12885,3483848,5,7462458,7462932,7462695,474
12886,3483848,5,24958866,24958918,24958892,52
12887,3483849,1,4943929,4944035,4943982,106
12888,3483849,1,12689895,12691446,12690670,1551
12889,3483849,1,26341458,26341853,26341655,395
12890,3483849,2,6244110,6245071,6244590,961
12891,3483849,3,10141715,10141890,10141802,175
12892,3483849,4,3371492,3372303,3371897,811
12893,3483849,4,4203676,4204120,4203898,444
12894,3483849,4,4842944,4844089,4843516,1145
12895,3483849,4,12519485,12520145,12519815,660
12896,3483849,4,17561935,17562560,17562247,625
12897,3483849,5,9015956,9016643,9016299,687
12898,3483849,5,9847554,9847698,9847626,144
12899,3483850,1,4943495,4943754,4943624,259
12900,3483850,1,12691611,12695071,12693341,3460
12901,3483850,1,26327802,26327895,26327848,93
12902,3483850,2,6272912,6272999,6272955,87
12903,3483850,3,10137639,10137915,10137777,276
12904,3483850,4,4202674,4202863,4202768,189
12905,3483850,4,12523162,12523834,12523498,672
12906,3483850,4,17560444,17560529,17560486,85
12907,3483850,5,9021336,9024322,9022829,2986
12908,3483850,5,9852177,9852480,9852328,303
12909,3483851,1,6559004,6561098,6560051,2094
12910,3483852,1,2475953,2476258,2476105,305
12911,3483852,1,5426505,5426822,5426663,317
12912,3483852,1,25497948,25498936,25498442,988
12913,3483852,1,29503257,29503945,29503601,688
12914,3483852,2,1561026,1563204,1562115,2178
12915,3483852,2,14442224,14442253,14442238,29
12916,3483852,3,18733377,18740868,18737122,7491
12917,3483852,4,5737875,5739124,5738499,1249
12918,3483852,4,10215697,10215700,10215698,3
12919,3483852,5,7469688,7469772,7469730,84
12920,3483853,1,4893442,4893512,4893477,70
12921,3483853,1,12059878,12061061,12060469,1183
12922,3483853,1,25635459,25635818,25635638,359
12923,3483853,2,648059,648122,648090,63
12924,3483853,2,1256396,1256564,1256480,168
12925,3483853,3,4079007,4079372,4079189,365
12926,3483853,4,1304301,1304317,1304309,16
12927,3483853,4,10077511,10077702,10077606,191
12928,3483853,5,780692,781776,781234,1084
12929,3483853,5,8553751,8553978,8553864,227
12930,3483854,1,2208184,2208201,2208192,17
12931,3483854,1,13145626,13145640,13145633,14
12932,3483854,1,22538401,22538520,22538460,119
12933,3483854,2,10429100,10429250,10429175,150
12934,3483854,2,15144455,15144614,15144534,159
12935,3483854,3,1540553,1540710,1540631,157
12936,3483854,3,2970354,2973067,2971710,2713
12937,3483854,5,2186112,2189921,2188016,3809
12938,3483855,1,2198174,2201141,2199657,2967
12939,3483855,1,13123981,13124605,13124293,624
12940,3483855,1,22529014,22529765,22529389,751
12941,3483855,2,10426697,10426803,10426750,106
12942,3483855,2,15140045,15140195,15140120,150
12943,3483855,3,1540553,1540710,1540631,157
12944,3483855,3,2995942,2996051,2995996,109
12945,3483855,5,2186852,2189921,2188386,3069
12946,3483856,2,1640902,1641334,1641118,432
12947,3483856,2,7765865,7766588,7766226,723
12948,3483856,2,19008000,19009329,19008664,1329
12949,3483856,3,5334507,5334543,5334525,36
12950,3483856,3,16863216,16863257,16863236,41
12951,3483856,3,21297646,21298252,21297949,606
12952,3483856,4,6794205,6794524,6794364,319
12953,3483856,4,14408542,14411369,14409955,2827
12954,3483856,5,842690,843322,843006,632
12955,3483856,5,18033763,18033859,18033811,96
12956,3483856,5,21394659,21394771,21394715,112
12957,3483857,1,12486219,12486644,12486431,425
12958,3483857,1,24578147,24579817,24578982,1670
12959,3483857,2,93778,94141,93959,363
12960,3483857,2,18298811,18299169,18298990,358
12961,3483857,4,1539210,1539232,1539221,22
12962,3483857,4,11798324,11799001,11798662,677
12963,3483858,1,16879736,16880319,16880027,583
12964,3483858,2,1031470,1031845,1031657,375
12965,3483858,3,9494642,9494761,9494701,119
12966,3483858,3,23291469,23291586,23291527,117
12967,3483858,5,17309495,17309594,17309544,99
12968,3483858,5,22502315,22502618,22502466,303
12969,3483858,5,25753717,25753761,25753739,44
12970,3483859,1,2851027,2851108,2851067,81
12971,3483859,1,28456198,28458552,28457375,2354
12972,3483859,3,22918594,22919154,22918874,560
12973,3483859,4,9283540,9286902,9285221,3362
12974,3483859,4,14344064,14345835,14344949,1771
12975,3483859,5,13226056,13226391,13226223,335
12976,3483860,1,19441710,19441937,19441823,227
12977,3483860,1,27330812,27331541,27331176,729
12978,3483860,2,7052505,7052641,7052573,136
12979,3483860,2,18588647,18589678,18589162,1031
12980,3483860,3,2695849,2697374,2696611,1525
12981,3483860,3,9057051,9057487,9057269,436
12982,3483860,3,16564965,16565564,16565264,599
12983,3483860,3,17461113,17461170,17461141,57
12984,3483860,4,7636799,7637426,7637112,627
12985,3483860,5,18945536,18945789,18945662,253
12986,3483860,5,24079284,24080733,24080008,1449
12987,3483861,2,7499218,7499279,7499248,61
12988,3483861,2,10668993,10670156,10669574,1163
12989,3483861,3,10060307,10062178,10061242,1871
12990,3483861,3,17401044,17401191,17401117,147
12991,3483861,4,5297446,5297858,5297652,412
12992,3483861,4,16661954,16664435,16663194,2481
12993,3483861,5,14898315,14899551,14898933,1236
12994,3483861,5,23094822,23095022,23094922,200
12995,3483862,1,10113474,10113929,10113701,455
12996,3483862,1,27133048,27133306,27133177,258
12997,3483862,2,15049830,15049831,15049830,1
12998,3483862,2,19070541,19073911,19072226,3370
12999,3483862,3,2129367,2129988,2129677,621
13000,3483862,4,302100,302639,302369,539
13001,3483862,4,5737525,5737587,5737556,62
13002,3483863,1,3539437,3539882,3539659,445
13003,3483863,1,17203127,17203722,17203424,595
13004,3483863,2,1467056,1467621,1467338,565
13005,3483863,3,15729325,15729342,15729333,17
13006,3483863,4,8053393,8055197,8054295,1804
13007,3483863,5,5789842,5790147,5789994,305
13008,3483863,5,14550211,14550237,14550224,26
13009,3483863,5,18582589,18582830,18582709,241
13010,3483863,5,26907724,26907772,26907748,48
13011,3483864,1,1866136,1866304,1866220,168
13012,3483864,1,7764884,7765037,7764960,153
13013,3483864,1,10599896,10599952,10599924,56
13014,3483864,1,20006392,20006475,20006433,83
13015,3483864,2,1443049,1443793,1443421,744
13016,3483864,2,1867167,1867715,1867441,548
13017,3483864,3,7968216,7968489,7968352,273
13018,3483864,4,17183811,17184663,17184237,852
13019,3483864,5,16850603,16850726,16850664,123
13020,3483864,5,26335463,26336155,26335809,692
13021,3483865,1,8448489,8448613,8448551,124
13022,3483865,1,9213362,9213916,9213639,554
13023,3483865,1,27348230,27348411,27348320,181
13024,3483865,2,1443049,1443793,1443421,744
13025,3483865,2,18111921,18112463,18112192,542
13026,3483865,3,21195020,21195245,21195132,225
13027,3483865,4,11021154,11021561,11021357,407
13028,3483865,4,15991502,15991956,15991729,454
13029,3483865,5,10300913,10301667,10301290,754
13030,3483865,5,23372339,23373121,23372730,782
13031,3483866,1,3716243,3716278,3716260,35
13032,3483866,1,11637479,11637560,11637519,81
13033,3483866,1,26786203,26786665,26786434,462
13034,3483866,2,1490976,1491084,1491030,108
13035,3483866,2,8678880,8680425,8679652,1545
13036,3483866,2,18789457,18789990,18789723,533
13037,3483867,3,1859390,1859883,1859636,493
13038,3483867,5,25030334,25032814,25031574,2480
13039,3483868,1,8305551,8307104,8306327,1553
13040,3483868,1,16770625,16771460,16771042,835
13041,3483868,1,28414046,28414098,28414072,52
13042,3483868,2,8226004,8227684,8226844,1680
13043,3483868,2,18855373,18855483,18855428,110
13044,3483868,3,2806464,2806602,2806533,138
13045,3483868,4,1345954,1346229,1346091,275
13046,3483868,4,6816652,6816786,6816719,134
13047,3483868,5,1687134,1692868,1690001,5734
13048,3483868,5,10451916,10452265,10452090,349
13049,3483869,1,445271,446882,446076,1611
13050,3483869,1,21415153,21415213,21415183,60
13051,3483869,4,723628,723825,723726,197
13052,3483869,5,26494221,26494900,26494560,679
13053,3483870,1,7664552,7664584,7664568,32
13054,3483870,1,17180376,17180427,17180401,51
13055,3483870,1,28420417,28423407,28421912,2990
13056,3483870,4,1396166,1397028,1396597,862
13057,3483870,5,6108824,6111138,6109981,2314
13058,3483870,5,26392430,26393929,26393179,1499
13059,3483871,1,7784844,7784998,7784921,154
13060,3483871,1,17259346,17265476,17262411,6130
13061,3483871,3,18504346,18504412,18504379,66
13062,3483871,4,8385673,8386785,8386229,1112
13063,3483871,5,7666218,7666515,7666366,297
13064,3483871,5,16080369,16080383,16080376,14
13065,3483871,5,17535969,17536092,17536030,123
13066,3483871,5,22185936,22186012,22185974,76
13067,3483872,1,3715303,3715668,3715485,365
13068,3483872,1,17188558,17188627,17188592,69
13069,3483872,3,9147808,9147929,9147868,121
13070,3483872,3,18894090,18894157,18894123,67
13071,3483872,4,5386252,5386303,5386277,51
13072,3483872,4,5737943,5739124,5738533,1181
13073,3483872,4,16659568,16660456,16660012,888
13074,3483872,5,3474597,3475116,3474856,519
13075,3483872,5,10893432,10893531,10893481,99
13076,3483872,5,13228564,13228657,13228610,93
13077,3483872,5,26271896,26272479,26272187,583
13078,3483873,1,177042,178456,177749,1414
13079,3483873,1,10583074,10583075,10583074,1
13080,3483873,1,28623860,28624015,28623937,155
13081,3483873,2,10203691,10203756,10203723,65
13082,3483873,2,15978810,15979836,15979323,1026
13083,3483873,2,18432264,18433199,18432731,935
13084,3483873,3,19413571,19413592,19413581,21
13085,3483873,3,22934311,22934322,22934316,11
13086,3483873,4,1225406,1225517,1225461,111
13087,3483873,4,12707210,12707970,12707590,760
13088,3483873,5,7272698,7272751,7272724,53
13089,3483873,5,26693492,26693663,26693577,171
13090,3483874,1,4772855,4773285,4773070,430
13091,3483874,1,21916357,21916358,21916357,1
13092,3483874,2,1494546,1494643,1494594,97
13093,3483874,2,16753514,16753958,16753736,444
13094,3483874,2,17240048,17240156,17240102,108
13095,3483874,3,20007155,20008992,20008073,1837
13096,3483874,5,1374572,1376883,1375727,2311
13097,3483874,5,10150120,10150212,10150166,92
13098,3483874,5,15594530,15595933,15595231,1403
13099,3483875,1,4925172,4925773,4925472,601
13100,3483875,1,6247522,6248012,6247767,490
13101,3483875,1,19553118,19553810,19553464,692
13102,3483875,2,1697258,1697501,1697379,243
13103,3483875,2,7277127,7277975,7277551,848
13104,3483875,3,8904940,8905291,8905115,351
13105,3483875,3,11076478,11076592,11076535,114
13106,3483875,3,21824817,21825067,21824942,250
13107,3483875,4,6062338,6062839,6062588,501
13108,3483875,4,12255142,12255562,12255352,420
13109,3483875,5,894266,895470,894868,1204
13110,3483875,5,3505215,3505485,3505350,270
13111,3483875,5,18663821,18663826,18663823,5
13112,3483876,1,10257166,10257567,10257366,401
13113,3483876,1,26017455,26017640,26017547,185
13114,3483876,2,7096318,7096380,7096349,62
13115,3483876,2,19101465,19101619,19101542,154
13116,3483876,3,9787762,9787944,9787853,182
13117,3483876,4,6729051,6729160,6729105,109
13118,3483876,4,7785023,7785146,7785084,123
13119,3483876,5,1579744,1579897,1579820,153
13120,3483876,5,5457075,5457767,5457421,692
13121,3483877,1,17169045,17169291,17169168,246
13122,3483877,2,15528118,15528343,15528230,225
13123,3483877,3,11003132,11003327,11003229,195
13124,3483877,5,9150385,9150436,9150410,51
13125,3483877,5,22997490,22997968,22997729,478
13126,3483878,1,8393795,8393960,8393877,165
13127,3483878,1,13289876,13290878,13290377,1002
13128,3483878,1,27497339,27497758,27497548,419
13129,3483878,2,6864209,6864593,6864401,384
13130,3483878,2,10321263,10323156,10322209,1893
13131,3483878,3,7924136,7924392,7924264,256
13132,3483878,3,10184311,10184429,10184370,118
13133,3483878,4,11247267,11247770,11247518,503
13134,3483878,4,15704253,15704384,15704318,131
13135,3483878,5,9968910,9969044,9968977,134
13136,3483879,1,17720375,17720415,17720395,40
13137,3483879,1,29741120,29742547,29741833,1427
13138,3483879,2,319327,320244,319785,917
13139,3483879,2,19227692,19227981,19227836,289
13140,3483879,4,4863124,4863455,4863289,331
13141,3483879,5,14864283,14864740,14864511,457
13142,3483879,5,15431646,15433040,15432343,1394
13143,3483880,1,16645456,16645848,16645652,392
13144,3483880,1,24962505,24964459,24963482,1954
13145,3483880,2,2099643,2099712,2099677,69
13146,3483880,5,13894351,13895488,13894919,1137
13147,3483881,2,12362996,12364001,12363498,1005
13148,3483881,2,18724858,18726076,18725467,1218
13149,3483881,4,7587165,7590074,7588619,2909
13150,3483881,5,4766376,4766736,4766556,360
13151,3483881,5,7311704,7311759,7311731,55
13152,3483882,1,27112987,27113008,27112997,21
13153,3483882,2,6843591,6843734,6843662,143
13154,3483882,2,17429317,17429340,17429328,23
13155,3483882,3,11732657,11732686,11732671,29
13156,3483882,4,177244,177417,177330,173
13157,3483882,4,802601,802720,802660,119
13158,3483882,5,15407770,15408161,15407965,391
13159,3483882,5,25823545,25823911,25823728,366
13160,3483882,5,26019725,26019860,26019792,135
13161,3483883,3,9720287,9720894,9720590,607
13162,3483883,3,10923663,10923762,10923712,99
13163,3483883,4,16500165,16501196,16500680,1031
13164,3483883,5,762756,763291,763023,535
13165,3483883,5,17387980,17388117,17388048,137
13166,3483884,1,24432057,24432467,24432262,410
13167,3483884,2,1044260,1044771,1044515,511
13168,3483884,2,6167063,6167554,6167308,491
13169,3483884,2,12331836,12333915,12332875,2079
13170,3483884,3,10518500,10518609,10518554,109
13171,3483884,5,14882963,14883432,14883197,469
13172,3483884,5,16516382,16516751,16516566,369
13173,3483885,1,7373779,7374339,7374059,560
13174,3483885,1,27652280,27652407,27652343,127
13175,3483885,2,680088,681510,680799,1422
13176,3483885,2,5522177,5522238,5522207,61
13177,3483885,3,12100531,12100595,12100563,64
13178,3483885,3,18946534,18947626,18947080,1092
13179,3483885,4,6828857,6829973,6829415,1116
13180,3483886,1,4291206,4291941,4291573,735
13181,3483886,1,7639278,7640441,7639859,1163
13182,3483886,1,17229846,17230891,17230368,1045
13183,3483886,1,28323933,28324004,28323968,71
13184,3483886,2,7004688,7004826,7004757,138
13185,3483886,2,16107455,16109383,16108419,1928
13186,3483886,3,18511973,18512537,18512255,564
13187,3483886,5,685142,685511,685326,369
13188,3483886,5,17622063,17622883,17622473,820
13189,3483887,1,27091471,27091996,27091733,525
13190,3483887,2,495253,496309,495781,1056
13191,3483887,2,2323853,2323898,2323875,45
13192,3483887,2,17150356,17151963,17151159,1607
13193,3483887,2,18962044,18963642,18962843,1598
13194,3483887,3,1853762,1855020,1854391,1258
13195,3483887,3,20603229,20603363,20603296,134
13196,3483887,4,7961571,7962185,7961878,614
13197,3483888,1,1065433,1067618,1066525,2185
13198,3483888,1,7907866,7907931,7907898,65
13199,3483888,1,12002270,12003586,12002928,1316
13200,3483888,1,12711885,12712412,12712148,527
13201,3483888,1,13203429,13203474,13203451,45
13202,3483888,2,1132666,1133676,1133171,1010
13203,3483888,2,18397778,18399815,18398796,2037
13204,3483888,4,5246805,5247922,5247363,1117
13205,3483888,4,6461396,6461594,6461495,198
13206,3483888,5,9292599,9292644,9292621,45
13207,3483888,5,15192518,15192571,15192544,53
13208,3483888,5,26105622,26105682,26105652,60
13209,3483889,1,7531920,7532617,7532268,697
13210,3483889,1,12694568,12695071,12694819,503
13211,3483889,1,26339156,26341458,26340307,2302
13212,3483889,2,806708,806790,806749,82
13213,3483889,2,6219349,6219748,6219548,399
13214,3483889,2,17041750,17042221,17041985,471
13215,3483889,3,6478074,6478860,6478467,786
13216,3483889,5,15402214,15402668,15402441,454
13217,3483889,5,24363309,24363940,24363624,631
13218,3483890,2,7897733,7898239,7897986,506
13219,3483890,2,12890635,12890830,12890732,195
13220,3483890,3,1443640,1443931,1443785,291
13221,3483890,3,9418919,9419385,9419152,466
13222,3483890,3,19942383,19942532,19942457,149
13223,3483890,5,9521779,9521901,9521840,122
13224,3483890,5,10292522,10292972,10292747,450
13225,3483891,1,18354603,18355363,18354983,760
13226,3483891,1,25606422,25607798,25607110,1376
13227,3483891,1,26187987,26188099,26188043,112
13228,3483891,2,232781,233250,233015,469
13229,3483891,2,12002432,12002449,12002440,17
13230,3483891,3,10540580,10540681,10540630,101
13231,3483891,3,17591206,17592033,17591619,827
13232,3483891,4,7975527,7975784,7975655,257
13233,3483891,5,7708542,7709221,7708881,679
13234,3483891,5,24384033,24384148,24384090,115
13235,3483892,1,17961788,17961871,17961829,83
13236,3483892,1,24986198,24986252,24986225,54
13237,3483892,2,18477600,18480167,18478883,2567
13238,3483892,3,8266319,8267157,8266738,838
13239,3483892,3,14941588,14941629,14941608,41
13240,3483892,3,19846898,19850716,19848807,3818
13241,3483892,4,530419,531859,531139,1440
13242,3483892,4,14045542,14047122,14046332,1580
13243,3483892,5,17999757,18000345,18000051,588
13244,3483892,5,26280270,26280898,26280584,628
13245,3483893,1,6528402,6528543,6528472,141
13246,3483893,1,23369732,23370714,23370223,982
13247,3483893,2,368010,368988,368499,978
13248,3483893,2,15072887,15074465,15073676,1578
13249,3483893,3,3714660,3714859,3714759,199
13250,3483893,3,8657961,8658238,8658099,277
13251,3483893,4,6424400,6424499,6424449,99
13252,3483893,4,17214715,17215290,17215002,575
13253,3483893,5,2176113,2178111,2177112,1998
13254,3483894,4,9333543,9334225,9333884,682
13255,3483894,5,16597012,16597298,16597155,286
13256,3483895,2,467122,468207,467664,1085
13257,3483895,2,11674125,11674816,11674470,691
13258,3483895,2,12594344,12594959,12594651,615
13259,3483895,3,4348140,4348961,4348550,821
13260,3483895,3,18239401,18239564,18239482,163
13261,3483895,4,527653,527682,527667,29
13262,3483895,4,9859501,9859803,9859652,302
13263,3483895,4,16722313,16722485,16722399,172
13264,3483895,5,1561265,1562536,1561900,1271
13265,3483896,1,4545675,4546134,4545904,459
13266,3483896,1,17368591,17368662,17368626,71
13267,3483896,1,19656476,19656488,19656482,12
13268,3483896,1,26707645,26707698,26707671,53
13269,3483896,2,6037985,6038047,6038016,62
13270,3483896,2,13032730,13034577,13033653,1847
13271,3483896,4,11662279,11662426,11662352,147
13272,3483896,4,12986896,12988298,12987597,1402
13273,3483896,4,14313271,14313512,14313391,241
13274,3483896,5,4102763,4104308,4103535,1545
13275,3483896,5,4128216,4128613,4128414,397
13276,3483896,5,10488717,10488855,10488786,138
13277,3483897,1,9352264,9352910,9352587,646
13278,3483897,1,9777788,9778332,9778060,544
13279,3483897,2,258703,258945,258824,242
13280,3483897,2,16637610,16638274,16637942,664
13281,3483897,2,19203633,19205092,19204362,1459
13282,3483897,3,10610659,10610919,10610789,260
13283,3483897,3,19443936,19443988,19443962,52
13284,3483897,4,6832759,6832879,6832819,120
13285,3483897,5,18089342,18092008,18090675,2666
13286,3483898,1,16134201,16134241,16134221,40
13287,3483898,2,373224,373365,373294,141
13288,3483898,2,2100749,2100773,2100761,24
13289,3483898,2,11910530,11910625,11910577,95
13290,3483898,3,8110974,8111500,8111237,526
13291,3483898,3,10925573,10925757,10925665,184
13292,3483898,3,17703335,17704335,17703835,1000
13293,3483898,4,6285906,6286001,6285953,95
13294,3483898,4,11880222,11880585,11880403,363
13295,3483898,5,9847357,9847554,9847455,197
13296,3483898,5,10136659,10136917,10136788,258
13297,3483898,5,26929192,26929400,26929296,208
13298,3483899,1,1889687,1891186,1890436,1499
13299,3483899,1,11822267,11822350,11822308,83
13300,3483899,2,5527013,5528599,5527806,1586
13301,3483899,3,14940501,14940751,14940626,250
13302,3483899,5,10263540,10264946,10264243,1406
13303,3483900,1,18487173,18487724,18487448,551
13304,3483900,2,14725392,14726397,14725894,1005
13305,3483900,3,7371274,7371718,7371496,444
13306,3483900,4,8298704,8299773,8299238,1069
13307,3483900,4,9255960,9256498,9256229,538
13308,3483900,5,7625906,7626279,7626092,373
13309,3483900,5,8036683,8040294,8038488,3611
13310,3483900,5,16090317,16092181,16091249,1864
13311,3483900,5,26655222,26655837,26655529,615
13312,3483901,1,3918247,3918489,3918368,242
13313,3483901,2,2264453,2264466,2264459,13
13314,3483901,2,17947699,17950237,17948968,2538
13315,3483901,3,6098399,6098732,6098565,333
13316,3483901,4,16714963,16715183,16715073,220
13317,3483901,5,2013273,2013504,2013388,231
13318,3483901,5,4646556,4647184,4646870,628
13319,3483901,5,15809996,15810270,15810133,274
13320,3483902,1,17211213,17211863,17211538,650
13321,3483902,2,260241,261747,260994,1506
13322,3483902,3,11100136,11100239,11100187,103
13323,3483902,3,12594210,12595702,12594956,1492
13324,3483902,4,6255594,6255725,6255659,131
13325,3483902,5,8295020,8296999,8296009,1979
13326,3483903,1,9829848,9830362,9830105,514
13327,3483903,2,13994805,13996526,13995665,1721
13328,3483903,3,10185042,10185861,10185451,819
13329,3483903,5,774497,774729,774613,232
13330,3483903,5,10486602,10488095,10487348,1493
13331,3483903,5,13652510,13652592,13652551,82
13332,3483903,5,25125471,25126957,25126214,1486
13333,3483904,1,7045847,7045933,7045890,86
13334,3483904,1,28151760,28152727,28152243,967
13335,3483904,2,9976517,9977763,9977140,1246
13336,3483904,2,13584141,13584287,13584214,146
13337,3483904,3,7622162,7623520,7622841,1358
13338,3483904,3,7700510,7700959,7700734,449
13339,3483904,3,22435549,22435766,22435657,217
13340,3483904,3,23215759,23220565,23218162,4806
13341,3483904,5,8663001,8664195,8663598,1194
13342,3483904,5,15657912,15658368,15658140,456
13343,3483904,5,26585347,26585451,26585399,104
13344,3483905,1,17988264,17988356,17988310,92
13345,3483905,1,27090106,27090182,27090144,76
13346,3483905,2,13702847,13703545,13703196,698
13347,3483905,3,15967176,15967306,15967241,130
13348,3483905,4,8608678,8609551,8609114,873
13349,3483905,5,6972753,6972914,6972833,161
13350,3483905,5,10705319,10705501,10705410,182
13351,3483905,5,26515079,26515551,26515315,472
13352,3483906,1,7764213,7765037,7764625,824
13353,3483906,1,8358831,8358841,8358836,10
13354,3483906,1,29180520,29181832,29181176,1312
13355,3483906,2,1515341,1515598,1515469,257
13356,3483906,3,22095561,22097944,22096752,2383
13357,3483906,4,7250763,7250928,7250845,165
13358,3483906,5,9346699,9347210,9346954,511
13359,3483907,1,7731429,7731453,7731441,24
13360,3483907,1,11913444,11914409,11913926,965
13361,3483907,1,25701675,25702694,25702184,1019
13362,3483907,2,1682756,1683082,1682919,326
13363,3483907,2,8671009,8671587,8671298,578
13364,3483907,3,7134406,7135285,7134845,879
13365,3483907,3,18783063,18783562,18783312,499
13366,3483907,4,194280,194455,194367,175
13367,3483907,4,13670757,13672610,13671683,1853
13368,3483907,5,6071648,6071753,6071700,105
13369,3483907,5,13893090,13893174,13893132,84
13370,3483907,5,17990855,17991095,17990975,240
13371,3483907,5,26906227,26906395,26906311,168
13372,3483908,1,17447115,17447134,17447124,19
13373,3483908,2,7822694,7822963,7822828,269
13374,3483908,2,15075160,15075195,15075177,35
13375,3483908,3,10942442,10942527,10942484,85
13376,3483908,3,20530484,20530611,20530547,127
13377,3483908,4,7432611,7433442,7433026,831
13378,3483909,1,3025355,3025864,3025609,509
13379,3483909,1,11631213,11633589,11632401,2376
13380,3483909,1,16646045,16646252,16646148,207
13381,3483909,1,27171700,27171837,27171768,137
13382,3483909,2,16798194,16798456,16798325,262
13383,3483909,3,1117903,1119292,1118597,1389
13384,3483909,3,16188602,16188732,16188667,130
13385,3483909,4,6049747,6050502,6050124,755
13386,3483909,4,6186038,6186109,6186073,71
13387,3483909,4,9448398,9448645,9448521,247
13388,3483909,5,2190518,2191851,2191184,1333
13389,3483911,2,15902563,15903015,15902789,452
13390,3483911,2,18464519,18465504,18465011,985
13391,3483911,3,4344146,4346182,4345164,2036
13392,3483911,4,7317608,7318570,7318089,962
13393,3483911,4,17868392,17870085,17869238,1693
13394,3483911,5,980549,980849,980699,300
13395,3483911,5,4750155,4750572,4750363,417
13396,3483911,5,15316792,15317553,15317172,761
13397,3483911,5,16995216,16995822,16995519,606
13398,3483912,1,29785896,29786336,29786116,440
13399,3483912,2,5797897,5798705,5798301,808
13400,3483912,2,6214560,6215132,6214846,572
13401,3483912,3,20118897,20119061,20118979,164
13402,3483912,4,7369220,7369626,7369423,406
13403,3483912,4,17766517,17768432,17767474,1915
13404,3483912,5,8185750,8185920,8185835,170
13405,3483912,5,10149868,10150120,10149994,252
13406,3483912,5,25180333,25182405,25181369,2072
13407,3483913,1,19681649,19681724,19681686,75
13408,3483913,1,28630915,28631772,28631343,857
13409,3483913,3,5824048,5825150,5824599,1102
13410,3483913,4,7250763,7250928,7250845,165
13411,3483913,5,23353819,23354052,23353935,233
13412,3483914,1,8714103,8714506,8714304,403
13413,3483914,1,12645082,12645355,12645218,273
13414,3483914,1,29606707,29608212,29607459,1505
13415,3483914,2,19469193,19469437,19469315,244
13416,3483914,3,6846813,6846843,6846828,30
13417,3483914,4,9936425,9936528,9936476,103
13418,3483914,5,2367945,2368057,2368001,112
13419,3483914,5,8876444,8877618,8877031,1174
13420,3483914,5,21423506,21424224,21423865,718
13421,3483915,1,11530553,11530689,11530621,136
13422,3483915,1,28251716,28252083,28251899,367
13423,3483915,2,2909133,2909189,2909161,56
13424,3483915,2,9893677,9894106,9893891,429
13425,3483915,3,8132487,8132747,8132617,260
13426,3483915,3,11381984,11382230,11382107,246
13427,3483915,4,216538,216640,216589,102
13428,3483915,4,6249005,6253063,6251034,4058
13429,3483915,5,16425317,16425400,16425358,83
13430,3483915,5,18671408,18671552,18671480,144
13431,3483916,1,3529228,3529232,3529230,4
13432,3483916,1,10957384,10957620,10957502,236
13433,3483916,1,24323034,24324985,24324009,1951
13434,3483916,2,6088065,6088483,6088274,418
13435,3483916,2,14232709,14235208,14233958,2499
13436,3483916,3,16807564,16808209,16807886,645
13437,3483916,4,11698417,11699677,11699047,1260
13438,3483916,5,15964769,15970886,15967827,6117
13439,3483917,1,11935714,11936615,11936164,901
13440,3483917,1,17399754,17402070,17400912,2316
13441,3483917,1,29444991,29445136,29445063,145
13442,3483917,2,9906754,9908063,9907408,1309
13443,3483917,3,2671271,2671852,2671561,581
13444,3483917,3,23022468,23022590,23022529,122
13445,3483917,4,5124344,5124594,5124469,250
13446,3483917,4,17711517,17711548,17711532,31
13447,3483917,5,24952102,24954450,24953276,2348
13448,3483918,1,19694210,19695428,19694819,1218
13449,3483918,1,24443891,24443906,24443898,15
13450,3483918,2,10373681,10374485,10374083,804
13451,3483918,2,15723768,15724136,15723952,368
13452,3483918,3,2176302,2177077,2176689,775
13453,3483918,3,9196850,9196874,9196862,24
13454,3483918,4,7443354,7443453,7443403,99
13455,3483918,4,17637628,17637904,17637766,276
13456,3483918,5,8378249,8378923,8378586,674
13457,3483918,5,9107862,9108007,9107934,145
13458,3483918,5,25289852,25289861,25289856,9
13459,3483919,1,25388754,25388913,25388833,159
13460,3483919,2,541600,541751,541675,151
13461,3483919,2,7846055,7846875,7846465,820
13462,3483919,3,6166262,6167047,6166654,785
13463,3483919,4,8660010,8660948,8660479,938
13464,3483919,5,309838,309884,309861,46
13465,3483919,5,26350402,26350424,26350413,22
13466,3483920,1,27528686,27528818,27528752,132
13467,3483920,2,11889349,11890003,11889676,654
13468,3483920,4,123960,124131,124045,171
13469,3483920,5,6137494,6139069,6138281,1575
13470,3483920,5,7869478,7869566,7869522,88
13471,3483920,5,10461557,10461657,10461607,100
13472,3483920,5,17588363,17589608,17588985,1245
13473,3483921,1,16711942,16713738,16712840,1796
13474,3483921,1,26115698,26116288,26115993,590
13475,3483921,2,15004218,15004366,15004292,148
13476,3483921,3,11445114,11445140,11445127,26
13477,3483921,3,18871076,18871567,18871321,491
13478,3483921,4,749519,749559,749539,40
13479,3483921,4,7331002,7331938,7331470,936
13480,3483921,5,5266626,5266654,5266640,28
13481,3483921,5,17683124,17683283,17683203,159
13482,3483921,5,26867665,26870688,26869176,3023
13483,3483922,1,9124621,9125046,9124833,425
13484,3483922,4,8910739,8910806,8910772,67
13485,3483922,5,2448179,2448202,2448190,23
13486,3483923,1,10294921,10295819,10295370,898
13487,3483923,1,29634716,29635673,29635194,957
13488,3483923,3,5862280,5863076,5862678,796
13489,3483923,3,9838140,9838931,9838535,791
13490,3483923,3,18579660,18587363,18583511,7703
13491,3483923,4,11478002,11478296,11478149,294
13492,3483923,5,15797809,15797989,15797899,180
13493,3483923,5,22127734,22128264,22127999,530
13494,3483924,1,26161237,26161402,26161319,165
13495,3483924,1,26319322,26320079,26319700,757
13496,3483924,2,7635824,7636240,7636032,416
13497,3483924,3,18422104,18423143,18422623,1039
13498,3483924,4,11250517,11250849,11250683,332
13499,3483924,4,16632369,16633316,16632842,947
13500,3483924,5,2409588,2409628,2409608,40
13501,3483924,5,24931947,24933451,24932699,1504
13502,3483925,1,9117065,9117257,9117161,192
13503,3483925,1,12734702,12734813,12734757,111
13504,3483925,2,9839259,9839752,9839505,493
13505,3483925,3,9026908,9028088,9027498,1180
13506,3483925,3,11833491,11833534,11833512,43
13507,3483925,5,16570097,16571505,16570801,1408
13508,3483926,1,5818410,5820915,5819662,2505
13509,3483926,1,15985406,15985772,15985589,366
13510,3483926,1,28929651,28930155,28929903,504
13511,3483926,2,12783385,12783726,12783555,341
13512,3483926,3,22861194,22862312,22861753,1118
13513,3483926,4,8734683,8734746,8734714,63
13514,3483926,4,17574767,17575194,17574980,427
13515,3483926,5,647566,647597,647581,31
13516,3483926,5,16317108,16317210,16317159,102
13517,3483927,1,11142458,11145727,11144092,3269
13518,3483927,1,12479124,12479892,12479508,768
13519,3483927,2,10850192,10851305,10850748,1113
13520,3483927,2,12902567,12902753,12902660,186
13521,3483927,3,4311744,4315468,4313606,3724
13522,3483927,3,15908641,15909199,15908920,558
13523,3483927,5,15451384,15452555,15451969,1171
13524,3483927,5,16146405,16146472,16146438,67
13525,3483928,1,670658,672329,671493,1671
13526,3483928,2,14697091,14700261,14698676,3170
13527,3483928,3,11692382,11692654,11692518,272
13528,3483928,4,4887026,4887549,4887287,523
13529,3483928,4,5338242,5338730,5338486,488
13530,3483928,5,18032990,18033139,18033064,149
13531,3483928,5,23671623,23671731,23671677,108
13532,3483929,1,10301548,10302378,10301963,830
13533,3483929,1,17281472,17281721,17281596,249
13534,3483929,1,24407242,24407561,24407401,319
13535,3483929,2,1627257,1629212,1628234,1955
13536,3483929,3,7851334,7851462,7851398,128
13537,3483929,4,5608145,5609239,5608692,1094
13538,3483929,4,13270644,13271338,13270991,694
13539,3483929,5,7598650,7599938,7599294,1288
13540,3483930,1,11936615,11937479,11937047,864
13541,3483930,1,29126868,29129630,29128249,2762
13542,3483930,3,9393660,9393775,9393717,115
13543,3483930,4,10479753,10479878,10479815,125
13544,3483930,4,15412708,15412896,15412802,188
13545,3483930,5,9686065,9687949,9687007,1884
13546,3483930,5,17805261,17805552,17805406,291
13547,3483931,2,2264435,2264727,2264581,292
13548,3483931,2,12332210,12333915,12333062,1705
13549,3483931,3,9834835,9835366,9835100,531
13550,3483931,4,820997,821127,821062,130
13551,3483931,5,18011223,18012642,18011932,1419
13552,3483931,5,23690633,23692100,23691366,1467
13553,3483931,5,26269048,26269065,26269056,17
13554,3483932,1,8148097,8148803,8148450,706
13555,3483932,2,10527234,10528669,10527951,1435
13556,3483932,2,14627278,14627559,14627418,281
13557,3483932,3,3795275,3795650,3795462,375
13558,3483932,3,16922437,16922849,16922643,412
13559,3483932,4,5440938,5441441,5441189,503
13560,3483932,4,6842754,6845098,6843926,2344
13561,3483932,4,14167553,14169635,14168594,2082
13562,3483932,5,5168004,5168326,5168165,322
13563,3483932,5,14623609,14623963,14623786,354
13564,3483933,1,3568596,3568820,3568708,224
13565,3483933,1,24099879,24099911,24099895,32
13566,3483933,3,10323023,10323909,10323466,886
13567,3483933,5,841050,841098,841074,48
13568,3483933,5,7528636,7528673,7528654,37
13569,3483933,5,18737472,18738328,18737900,856
13570,3483934,1,4780252,4780293,4780272,41
13571,3483934,1,19651919,19651943,19651931,24
13572,3483934,2,145227,145430,145328,203
13573,3483934,2,386140,386886,386513,746
13574,3483934,2,10270268,10270339,10270303,71
13575,3483934,2,15811136,15812126,15811631,990
13576,3483934,3,9708474,9708851,9708662,377
13577,3483934,5,985945,986177,986061,232
13578,3483934,5,8186757,8187643,8187200,886
13579,3483935,1,24410759,24410801,24410780,42
13580,3483935,3,9766133,9769603,9767868,3470
13581,3483935,4,696883,697026,696954,143
13582,3483935,4,16921453,16921516,16921484,63
13583,3483935,5,15363712,15363847,15363779,135
13584,3483936,2,6348814,6348874,6348844,60
13585,3483936,2,18605191,18606226,18605708,1035
13586,3483936,3,12100886,12101144,12101015,258
13587,3483936,4,10528337,10528498,10528417,161
13588,3483936,5,3317786,3318096,3317941,310
13589,3483936,5,9203820,9206727,9205273,2907
13590,3483936,5,17035182,17035419,17035300,237
13591,3483937,2,9716617,9716739,9716678,122
13592,3483937,2,18369074,18369343,18369208,269
13593,3483937,3,11282749,11283047,11282898,298
13594,3483937,4,5387587,5387661,5387624,74
13595,3483937,4,6092480,6092563,6092521,83
13596,3483937,4,17844688,17844690,17844689,2
13597,3483937,5,24334507,24336110,24335308,1603
13598,3483938,1,21182890,21183118,21183004,228
13599,3483938,1,27429547,27429587,27429567,40
13600,3483938,2,19159717,19160212,19159964,495
13601,3483938,3,5624559,5624697,5624628,138
13602,3483938,4,82555,82605,82580,50
13603,3483938,4,5514479,5514669,5514574,190
13604,3483938,5,18956451,18957806,18957128,1355
13605,3483939,1,5546817,5546843,5546830,26
13606,3483939,1,6142884,6142995,6142939,111
13607,3483939,3,399718,401321,400519,1603
13608,3483939,3,11457604,11457848,11457726,244
13609,3483939,5,15476931,15481586,15479258,4655
13610,3483939,5,21679110,21679133,21679121,23
13611,3483939,5,22269096,22269425,22269260,329
13612,3483940,1,13081122,13081297,13081209,175
13613,3483940,2,9988064,9988726,9988395,662
13614,3483940,2,13669091,13669179,13669135,88
13615,3483940,3,4432555,4432624,4432589,69
13616,3483940,3,10734561,10735209,10734885,648
13617,3483940,4,377528,377656,377592,128
13618,3483940,4,12222210,12222546,12222378,336
13619,3483940,5,8289822,8291907,8290864,2085
13620,3483941,2,2015400,2015539,2015469,139
13621,3483941,4,85566,86622,86094,1056
13622,3483941,4,6832169,6832334,6832251,165
13623,3483941,4,14273798,14274952,14274375,1154
13624,3483941,5,9258981,9260607,9259794,1626
13625,3483942,1,18629238,18629407,18629322,169
13626,3483942,2,11277682,11278620,11278151,938
13627,3483942,3,7121079,7121512,7121295,433
13628,3483942,4,14163314,14164740,14164027,1426
13629,3483942,5,348696,351703,350199,3007
13630,3483942,5,9084306,9084431,9084368,125
13631,3483942,5,18650440,18650596,18650518,156
13632,3483943,1,4612868,4613090,4612979,222
13633,3483943,1,21419333,21419752,21419542,419
13634,3483943,1,26682263,26683300,26682781,1037
13635,3483943,2,2323853,2323898,2323875,45
13636,3483943,3,1268972,1269609,1269290,637
13637,3483943,3,3469489,3469948,3469718,459
13638,3483943,3,10180050,10180072,10180061,22
13639,3483943,4,608584,608683,608633,99
13640,3483943,4,5374430,5377175,5375802,2745
13641,3483943,4,9351428,9352997,9352212,1569
13642,3483943,5,3843095,3843532,3843313,437
13643,3483943,5,6782702,6783422,6783062,720
13644,3483943,5,14717912,14718969,14718440,1057
13645,3483943,5,21959200,21960017,21959608,817
13646,3483943,5,25112426,25112631,25112528,205
13647,3483944,1,17341840,17344208,17343024,2368
13648,3483944,1,18439651,18440055,18439853,404
13649,3483944,2,1124214,1124985,1124599,771
13650,3483944,2,11150896,11153338,11152117,2442
13651,3483944,3,8920872,8921159,8921015,287
13652,3483944,3,11163834,11164240,11164037,406
13653,3483944,4,6209572,6209852,6209712,280
13654,3483944,4,11628431,11629661,11629046,1230
13655,3483944,5,9056617,9056792,9056704,175
13656,3483944,5,26806085,26806136,26806110,51
13657,3483945,1,4918015,4918129,4918072,114
13658,3483945,1,10173626,10173721,10173673,95
13659,3483945,1,10860971,10863773,10862372,2802
13660,3483945,1,19303027,19303100,19303063,73
13661,3483945,2,7985137,7985397,7985267,260
13662,3483945,2,16830797,16831633,16831215,836
13663,3483945,2,19020676,19021587,19021131,911
13664,3483945,3,6913628,6913660,6913644,32
13665,3483945,3,8021754,8022045,8021899,291
13666,3483945,3,15958489,15960044,15959266,1555
13667,3483945,3,18506350,18506376,18506363,26
13668,3483945,3,18967389,18967951,18967670,562
13669,3483945,4,8949730,8949793,8949761,63
13670,3483945,5,5930412,5931003,5930707,591
13671,3483945,5,7840350,7840823,7840586,473
13672,3483945,5,8439204,8439285,8439244,81
13673,3483945,5,9150102,9150109,9150105,7
13674,3483945,5,10614074,10616137,10615105,2063
13675,3483945,5,15467518,15467867,15467692,349
13676,3483945,5,25699402,25700200,25699801,798
13677,3483946,1,8302965,8303694,8303329,729
13678,3483946,2,7194986,7195039,7195012,53
13679,3483946,2,13826551,13826780,13826665,229
13680,3483946,3,14947733,14950258,14948995,2525
13681,3483946,3,17743502,17744508,17744005,1006
13682,3483946,4,72914,72941,72927,27
13683,3483946,5,9056617,9056792,9056704,175
13684,3483947,1,6615150,6615496,6615323,346
13685,3483947,2,10285163,10285239,10285201,76
13686,3483947,3,19525518,19525725,19525621,207
13687,3483947,3,22767184,22771425,22769304,4241
13688,3483947,5,9457947,9458003,9457975,56
13689,3483947,5,20491969,20492097,20492033,128
13690,3483947,5,23946746,23946975,23946860,229
13691,3483948,1,4188548,4188998,4188773,450
13692,3483948,1,17806263,17806487,17806375,224
13693,3483948,1,22540998,22541011,22541004,13
13694,3483948,2,9976517,9976934,9976725,417
13695,3483948,2,18494119,18494403,18494261,284
13696,3483948,3,1161417,1161604,1161510,187
13697,3483948,3,9315074,9315521,9315297,447
13698,3483948,4,5758681,5758925,5758803,244
13699,3483948,4,7376367,7377845,7377106,1478
13700,3483948,5,4670520,4670608,4670564,88
13701,3483948,5,10430808,10432261,10431534,1453
13702,3483948,5,13472371,13474947,13473659,2576
13703,3483948,5,22077982,22079616,22078799,1634
13704,3483949,1,26330784,26331428,26331106,644
13705,3483949,3,3430173,3430473,3430323,300
13706,3483949,3,21611819,21625792,21618805,13973
13707,3483949,4,7391330,7392916,7392123,1586
13708,3483949,5,15727850,15728048,15727949,198
13709,3483949,5,20938348,20938661,20938504,313
13710,3483950,1,17069204,17070471,17069837,1267
13711,3483950,1,24849673,24849774,24849723,101
13712,3483950,1,28630535,28630836,28630685,301
13713,3483950,2,7645547,7645583,7645565,36
13714,3483950,3,1793677,1793984,1793830,307
13715,3483950,3,10523016,10523408,10523212,392
13716,3483950,3,17516085,17516102,17516093,17
13717,3483950,4,6752193,6752205,6752199,12
13718,3483950,4,15519090,15519142,15519116,52
13719,3483950,5,787501,788312,787906,811
13720,3483950,5,16451115,16453212,16452163,2097
13721,3483950,5,22773439,22773770,22773604,331
13722,3483951,1,1593238,1594317,1593777,1079
13723,3483951,1,5925513,5926172,5925842,659
13724,3483951,1,16895165,16895495,16895330,330
13725,3483951,3,1755396,1755580,1755488,184
13726,3483951,3,11107568,11107726,11107647,158
13727,3483951,4,383873,384798,384335,925
13728,3483951,4,624508,624532,624520,24
13729,3483951,4,8478826,8479367,8479096,541
13730,3483951,4,18124186,18127540,18125863,3354
13731,3483951,5,8636721,8636857,8636789,136
13732,3483951,5,13865015,13865081,13865048,66
13733,3483951,5,25621224,25624155,25622689,2931
13734,3483952,1,1102330,1103616,1102973,1286
13735,3483952,1,17329604,17330414,17330009,810
13736,3483952,1,21056714,21056827,21056770,113
13737,3483952,3,3666785,3669247,3668016,2462
13738,3483952,3,7713445,7714229,7713837,784
13739,3483952,4,11350989,11352155,11351572,1166
13740,3483952,5,6442760,6443354,6443057,594
13741,3483953,1,4524579,4525122,4524850,543
13742,3483953,1,25492800,25493433,25493116,633
13743,3483953,2,7818732,7819061,7818896,329
13744,3483953,2,12347861,12349129,12348495,1268
13745,3483953,4,7426423,7428504,7427463,2081
13746,3483953,5,6756704,6756813,6756758,109
13747,3483954,2,6865260,6865343,6865301,83
13748,3483954,2,18623818,18623940,18623879,122
13749,3483954,3,2471259,2471421,2471340,162
13750,3483954,3,15831093,15834708,15832900,3615
13751,3483954,4,7718518,7718601,7718559,83
13752,3483954,5,761549,762689,762119,1140
13753,3483954,5,19908099,19908195,19908147,96
13754,3483955,1,19076666,19076835,19076750,169
13755,3483955,2,9286704,9286948,9286826,244
13756,3483955,3,23091323,23091799,23091561,476
13757,3483955,4,11111317,11124935,11118126,13618
13758,3483955,5,14317067,14317150,14317108,83
13759,3483956,1,8920715,8922466,8921590,1751
13760,3483956,1,16775720,16775816,16775768,96
13761,3483956,1,24132060,24132763,24132411,703
13762,3483956,2,1125220,1128956,1127088,3736
13763,3483956,3,7834596,7835003,7834799,407
13764,3483956,3,20273029,20273591,20273310,562
13765,3483956,3,22441743,22441962,22441852,219
13766,3483956,4,7597190,7597445,7597317,255
13767,3483956,4,16310825,16315444,16313134,4619
13768,3483956,5,6996801,6997492,6997146,691
13769,3483956,5,9312115,9312333,9312224,218
13770,3483957,1,4901255,4902678,4901966,1423
13771,3483957,3,4016391,4017176,4016783,785
13772,3483957,3,8143953,8144683,8144318,730
13773,3483957,3,18595186,18595224,18595205,38
13774,3483957,4,6806005,6806133,6806069,128
13775,3483957,4,10862060,10863310,10862685,1250
13776,3483957,5,9458251,9459538,9458894,1287
13777,3483958,1,16877597,16877770,16877683,173
13778,3483958,1,17328318,17328449,17328383,131
13779,3483958,2,545046,546765,545905,1719
13780,3483958,2,2096877,2097234,2097055,357
13781,3483958,3,1223666,1223793,1223729,127
13782,3483958,4,5660121,5660231,5660176,110
13783,3483958,4,6899522,6902133,6900827,2611
13784,3483958,5,13665203,13674034,13669618,8831
13785,3483958,5,21762451,21765750,21764100,3299
13786,3483959,1,1529744,1529880,1529812,136
13787,3483959,1,9652244,9652842,9652543,598
13788,3483959,1,27601923,27601932,27601927,9
13789,3483959,2,335140,335498,335319,358
13790,3483959,2,16048923,16049015,16048969,92
13791,3483959,3,17341271,17342607,17341939,1336
13792,3483959,5,9001046,9003896,9002471,2850
13793,3483959,5,15861706,15862308,15862007,602
13794,3483959,5,17734591,17736160,17735375,1569
13795,3483960,1,8659563,8659830,8659696,267
13796,3483960,1,13311870,13312326,13312098,456
13797,3483960,1,24655978,24656351,24656164,373
13798,3483960,2,672483,673037,672760,554
13799,3483960,2,12140463,12140659,12140561,196
13800,3483960,3,604839,604881,604860,42
13801,3483960,3,19449783,19450425,19450104,642
13802,3483960,4,6078491,6079160,6078825,669
13803,3483960,5,3239054,3239625,3239339,571
13804,3483960,5,22373036,22373264,22373150,228
13805,3483961,1,6865472,6866720,6866096,1248
13806,3483961,2,7384438,7384536,7384487,98
13807,3483961,2,18369011,18369074,18369042,63
13808,3483961,3,9581864,9583233,9582548,1369
13809,3483961,5,1393092,1394905,1393998,1813
13810,3483961,5,6836944,6836998,6836971,54
13811,3483961,5,13882718,13882918,13882818,200
13812,3483962,1,1143832,1144622,1144227,790
13813,3483962,1,5926172,5926266,5926219,94
13814,3483962,1,13153039,13153180,13153109,141
13815,3483962,1,25797037,25799721,25798379,2684
13816,3483962,2,2324616,2324837,2324726,221
13817,3483962,2,6017200,6018166,6017683,966
13818,3483962,3,1844312,1844755,1844533,443
13819,3483962,4,13526921,13527807,13527364,886
13820,3483962,5,663143,665386,664264,2243
13821,3483962,5,9238153,9243144,9240648,4991
13822,3483962,5,22890303,22890326,22890314,23
13823,3483963,1,24632225,24632979,24632602,754
13824,3483963,1,25276330,25278150,25277240,1820
13825,3483963,5,5928509,5929756,5929132,1247
13826,3483963,5,9058094,9058239,9058166,145
13827,3483963,5,22471664,22473063,22472363,1399
13828,3483963,5,23229802,23230047,23229924,245
13829,3483964,1,1557432,1557526,1557479,94
13830,3483964,1,26694637,26695280,26694958,643
13831,3483964,2,352047,352965,352506,918
13832,3483964,2,9722294,9722529,9722411,235
13833,3483964,3,10923253,10923576,10923414,323
13834,3483964,3,15933682,15934613,15934147,931
13835,3483964,4,5746857,5747582,5747219,725
13836,3483964,5,764809,765169,764989,360
13837,3483964,5,23685956,23685977,23685966,21
13838,3483965,1,26401520,26401546,26401533,26
13839,3483965,2,6793356,6795275,6794315,1919
13840,3483965,3,10987920,10988402,10988161,482
13841,3483965,4,5701150,5703908,5702529,2758
13842,3483965,4,17779911,17779930,17779920,19
13843,3483965,5,1586813,1586918,1586865,105
13844,3483965,5,9969601,9969746,9969673,145
13845,3483965,5,26754269,26754364,26754316,95
13846,3483966,1,1108601,1108812,1108706,211
13847,3483966,1,17383041,17384507,17383774,1466
13848,3483966,1,21090603,21090752,21090677,149
13849,3483966,3,3739206,3740273,3739739,1067
13850,3483966,3,7716791,7716795,7716793,4
13851,3483966,4,11415340,11415473,11415406,133
13852,3483966,5,6462022,6466254,6464138,4232
13853,3483967,2,7001264,7001480,7001372,216
13854,3483967,3,2827053,2827714,2827383,661
13855,3483967,4,17432701,17432997,17432849,296
13856,3483967,5,10127757,10128084,10127920,327
13857,3483968,2,6198583,6203314,6200948,4731
13858,3483968,2,10550759,10551290,10551024,531
13859,3483968,2,16172490,16172611,16172550,121
13860,3483968,3,11674442,11674660,11674551,218
13861,3483968,4,5476468,5482147,5479307,5679
13862,3483968,4,6496011,6497354,6496682,1343
13863,3483969,1,2820443,2820576,2820509,133
13864,3483969,1,9180073,9180674,9180373,601
13865,3483969,1,19485903,19487153,19486528,1250
13866,3483969,2,250337,250560,250448,223
13867,3483969,2,10847292,10847372,10847332,80
13868,3483969,3,3577770,3580015,3578892,2245
13869,3483969,4,15957253,15957621,15957437,368
13870,3483969,5,4632748,4632820,4632784,72
13871,3483970,1,1074146,1076505,1075325,2359
13872,3483970,1,8168729,8168759,8168744,30
13873,3483970,1,17222254,17222425,17222339,171
13874,3483970,1,26539975,26540170,26540072,195
13875,3483970,2,1846410,1846759,1846584,349
13876,3483970,3,7888169,7888250,7888209,81
13877,3483970,3,15751400,15752419,15751909,1019
13878,3483970,3,16361257,16361521,16361389,264
13879,3483970,4,18031407,18032650,18032028,1243
13880,3483970,5,731510,731883,731696,373
13881,3483970,5,21374030,21374492,21374261,462
13882,3483971,1,8630252,8630256,8630254,4
13883,3483971,1,30142865,30143082,30142973,217
13884,3483971,2,598356,598458,598407,102
13885,3483971,2,2271443,2271557,2271500,114
13886,3483971,3,17944454,17945561,17945007,1107
13887,3483971,3,19992918,19993128,19993023,210
13888,3483971,4,1135304,1135657,1135480,353
13889,3483971,4,16580798,16581340,16581069,542
13890,3483971,5,9542696,9542729,9542712,33
13891,3483971,5,23784824,23787657,23786240,2833
13892,3483972,2,6292131,6292384,6292257,253
13893,3483972,2,13109944,13110480,13110212,536
13894,3483972,4,8354002,8354954,8354478,952
13895,3483973,1,6843433,6845966,6844699,2533
13896,3483973,2,6669063,6670379,6669721,1316
13897,3483973,2,11566529,11569900,11568214,3371
13898,3483973,3,11540185,11540688,11540436,503
13899,3483973,4,5662060,5662073,5662066,13
13900,3483973,4,11947944,11949895,11948919,1951
13901,3483973,5,16601530,16602169,16601849,639
13902,3483973,5,26974654,26974785,26974719,131
13903,3483974,1,4542924,4542930,4542927,6
13904,3483974,1,23348074,23348281,23348177,207
13905,3483974,2,2294951,2294994,2294972,43
13906,3483974,2,7702727,7703408,7703067,681
13907,3483974,2,16196128,16200176,16198152,4048
13908,3483974,3,6007260,6007698,6007479,438
13909,3483974,4,122346,122429,122387,83
13910,3483974,4,11664664,11665161,11664912,497
13911,3483974,5,8895700,8895846,8895773,146
13912,3483974,5,10482709,10483300,10483004,591
13913,3483974,5,24788649,24789288,24788968,639
13914,3483975,1,11461309,11461361,11461335,52
13915,3483975,1,26478296,26478362,26478329,66
13916,3483975,3,8550809,8550927,8550868,118
13917,3483975,4,15873390,15873400,15873395,10
13918,3483976,1,12536723,12536747,12536735,24
13919,3483976,1,22401841,22402356,22402098,515
13920,3483976,2,9898748,9900298,9899523,1550
13921,3483976,4,20996,21200,21098,204
13922,3483976,4,5731037,5735057,5733047,4020
13923,3483976,4,14773951,14776161,14775056,2210
13924,3483976,5,18573101,18573821,18573461,720
13925,3483977,1,19910873,19911047,19910960,174
13926,3483977,1,28518621,28518692,28518656,71
13927,3483977,2,17498656,17498664,17498660,8
13928,3483977,3,1062302,1062570,1062436,268
13929,3483977,3,16652407,16652555,16652481,148
13930,3483977,3,17997590,17998989,17998289,1399
13931,3483977,5,25798497,25798774,25798635,277
13932,3483977,5,26305177,26305231,26305204,54
13933,3483978,1,6863006,6863325,6863165,319
13934,3483978,2,6817359,6817497,6817428,138
13935,3483978,3,17202185,17202223,17202204,38
13936,3483978,3,20858415,20858679,20858547,264
13937,3483978,4,943797,943974,943885,177
13938,3483978,4,5283991,5284838,5284414,847
13939,3483978,5,7813522,7813662,7813592,140
13940,3483978,5,13610545,13610705,13610625,160
13941,3483979,1,29361528,29361819,29361673,291
13942,3483979,2,842546,843531,843038,985
13943,3483979,2,8011412,8011827,8011619,415
13944,3483979,2,16634495,16634627,16634561,132
13945,3483979,3,2117758,2117925,2117841,167
13946,3483979,3,16127449,16127527,16127488,78
13947,3483979,4,6192288,6192568,6192428,280
13948,3483979,5,1203904,1204063,1203983,159
13949,3483979,5,15872761,15872917,15872839,156
13950,3483979,5,21047610,21047635,21047622,25
13951,3483980,1,25256709,25257241,25256975,532
13952,3483980,2,6785702,6785745,6785723,43
13953,3483980,2,10764671,10765275,10764973,604
13954,3483980,3,18658513,18659387,18658950,874
13955,3483980,4,14208440,14208731,14208585,291
13956,3483980,5,380239,381294,380766,1055
13957,3483980,5,19858559,19861267,19859913,2708
13958,3483980,5,20095839,20096275,20096057,436
13959,3483981,1,16844701,16844751,16844726,50
13960,3483981,1,27462926,27464028,27463477,1102
13961,3483981,2,11619363,11619595,11619479,232
13962,3483981,2,19014802,19014963,19014882,161
13963,3483981,3,19967571,19967615,19967593,44
13964,3483981,4,6748679,6748738,6748708,59
13965,3483981,5,13879924,13880739,13880331,815
13966,3483982,1,3399014,3399700,3399357,686
13967,3483982,1,9949552,9949685,9949618,133
13968,3483982,1,19687546,19687658,19687602,112
13969,3483982,2,16537077,16537252,16537164,175
13970,3483982,3,9657453,9657919,9657686,466
13971,3483982,4,10890314,10890768,10890541,454
13972,3483983,1,2750889,2752244,2751566,1355
13973,3483983,1,13043025,13043194,13043109,169
13974,3483983,1,25123852,25123938,25123895,86
13975,3483983,3,1223863,1223912,1223887,49
13976,3483983,3,15880618,15880700,15880659,82
13977,3483983,4,129094,130278,129686,1184
13978,3483983,4,15360446,15360534,15360490,88
13979,3483983,5,17250076,17255372,17252724,5296
13980,3483983,5,25036969,25038250,25037609,1281
13981,3483983,5,25336925,25337139,25337032,214
13982,3483984,1,6769024,6769149,6769086,125
13983,3483984,4,18099250,18100209,18099729,959
13984,3483984,5,2808266,2808294,2808280,28
13985,3483984,5,4256226,4256573,4256399,347
13986,3483984,5,7408759,7412243,7410501,3484
13987,3483984,5,18959851,18959987,18959919,136
13988,3483985,1,11561144,11562373,11561758,1229
13989,3483985,2,2926803,2927023,2926913,220
13990,3483985,2,6035843,6036484,6036163,641
13991,3483985,2,17415922,17416053,17415987,131
13992,3483985,3,5268523,5270734,5269628,2211
13993,3483985,3,9203209,9203269,9203239,60
13994,3483985,4,6769883,6769917,6769900,34
13995,3483985,4,10713555,10714555,10714055,1000
13996,3483985,4,18060133,18060884,18060508,751
13997,3483985,5,18991722,18991930,18991826,208
13998,3483986,1,16157572,16157626,16157599,54
13999,3483986,2,1014461,1015744,1015102,1283
14000,3483986,2,2089619,2089716,2089667,97
14001,3483986,2,9492597,9495876,9494236,3279
14002,3483986,2,15629309,15629409,15629359,100
14003,3483986,3,15699702,15699715,15699708,13
14004,3483986,3,17373484,17373531,17373507,47
14005,3483986,4,5168353,5168555,5168454,202
14006,3483986,4,13681866,13682388,13682127,522
14007,3483986,5,498565,499185,498875,620
14008,3483986,5,24385847,24387584,24386715,1737
14009,3483987,1,4649385,4650523,4649954,1138
14010,3483987,1,8989954,8990312,8990133,358
14011,3483987,1,17347054,17347133,17347093,79
14012,3483987,1,18310652,18311942,18311297,1290
14013,3483987,2,10149066,10149169,10149117,103
14014,3483987,3,8038617,8039426,8039021,809
14015,3483987,4,187613,188702,188157,1089
14016,3483987,4,1048582,1049580,1049081,998
14017,3483987,4,17624261,17628475,17626368,4214
14018,3483987,5,17615077,17615541,17615309,464
14019,3483987,5,21801502,21801634,21801568,132
14020,3483988,1,4061957,4062298,4062127,341
14021,3483988,1,12488202,12488470,12488336,268
14022,3483988,1,27667097,27668645,27667871,1548
14023,3483988,2,8373051,8373344,8373197,293
14024,3483988,2,8557284,8557420,8557352,136
14025,3483988,2,18355881,18356082,18355981,201
14026,3483988,3,12101144,12101499,12101321,355
14027,3483988,4,10296881,10297229,10297055,348
14028,3483988,5,9947627,9947896,9947761,269
14029,3483988,5,15805719,15805981,15805850,262
14030,3483989,3,8591508,8591800,8591654,292
14031,3483989,3,10693366,10693511,10693438,145
14032,3483989,4,11566908,11567205,11567056,297
14033,3483989,4,15085552,15085675,15085613,123
14034,3483989,5,8289337,8289822,8289579,485
14035,3483990,1,19409317,19409973,19409645,656
14036,3483990,1,24809419,24809664,24809541,245
14037,3483990,3,8665913,8666272,8666092,359
14038,3483990,3,10693776,10694107,10693941,331
14039,3483990,4,8003527,8003706,8003616,179
14040,3483991,1,1134230,1134414,1134322,184
14041,3483991,1,17709134,17709644,17709389,510
14042,3483991,1,21695885,21696177,21696031,292
14043,3483991,2,7048981,7049023,7049002,42
14044,3483991,2,13192011,13192090,13192050,79
14045,3483991,3,9810312,9811157,9810734,845
14046,3483991,4,1509129,1509511,1509320,382
14047,3483991,4,17498143,17498690,17498416,547
14048,3483991,5,21321023,21322274,21321648,1251
14049,3483991,5,26748648,26749055,26748851,407
14050,3483992,1,3918247,3918489,3918368,242
14051,3483992,1,26829895,26831437,26830666,1542
14052,3483992,2,6690538,6690577,6690557,39
14053,3483992,2,11778751,11782932,11780841,4181
14054,3483992,3,11107805,11108169,11107987,364
14055,3483992,4,11695668,11696223,11695945,555
14056,3483992,5,5614381,5614941,5614661,560
14057,3483992,5,18042334,18044675,18043504,2341
14058,3483992,5,18061579,18061869,18061724,290
14059,3483993,1,28177710,28178536,28178123,826
14060,3483993,2,13395638,13395652,13395645,14
14061,3483993,4,1496820,1497109,1496964,289
14062,3483993,5,26222851,26224228,26223539,1377
14063,3483994,1,7803086,7803175,7803130,89
14064,3483994,1,23383069,23384308,23383688,1239
14065,3483994,2,16788768,16788796,16788782,28
14066,3483994,3,5252876,5253129,5253002,253
14067,3483994,4,845167,845796,845481,629
14068,3483994,5,21602991,21605094,21604042,2103
14069,3483995,1,5465770,5465796,5465783,26
14070,3483995,1,6694780,6696060,6695420,1280
14071,3483995,2,6491822,6492009,6491915,187
14072,3483995,3,10170586,10170598,10170592,12
14073,3483995,3,16192075,16192292,16192183,217
14074,3483995,3,16803397,16803415,16803406,18
14075,3483996,1,11575703,11576206,11575954,503
14076,3483996,1,26824688,26825036,26824862,348
14077,3483996,3,10847139,10847537,10847338,398
14078,3483996,3,15658296,15658622,15658459,326
14079,3483996,4,6870467,6870916,6870691,449
14080,3483996,5,438328,438338,438333,10
14081,3483996,5,24277630,24277635,24277632,5
14082,3483997,1,17641753,17641825,17641789,72
14083,3483997,1,19319518,19319561,19319539,43
14084,3483997,2,7859928,7860527,7860227,599
14085,3483997,2,10149066,10149169,10149117,103
14086,3483997,2,15499012,15499255,15499133,243
14087,3483997,3,6301759,6302103,6301931,344
14088,3483997,4,6568902,6568932,6568917,30
14089,3483997,4,11354932,11355541,11355236,609
14090,3483997,5,763708,764459,764083,751
14091,3483997,5,3049905,3050014,3049959,109
14092,3483997,5,22324786,22329358,22327072,4572
14093,3483998,1,9375830,9375941,9375885,111
14094,3483998,1,9953210,9955111,9954160,1901
14095,3483998,2,7216791,7216869,7216830,78
14096,3483998,3,866910,867221,867065,311
14097,3483998,4,1201380,1201946,1201663,566
14098,3483998,4,17203217,17204054,17203635,837
14099,3483998,5,270689,270910,270799,221
14100,3483998,5,1796716,1797231,1796973,515
14101,3483999,1,25723780,25724003,25723891,223
14102,3483999,2,154196,154224,154210,28
14103,3483999,2,13491006,13491142,13491074,136
14104,3483999,2,16936562,16936596,16936579,34
14105,3483999,3,16894325,16894734,16894529,409
14106,3483999,4,11784542,11785027,11784784,485
14107,3483999,5,608168,608303,608235,135
14108,3483999,5,18364888,18364953,18364920,65
14109,3483999,5,21802756,21803107,21802931,351
14110,3484000,1,28631772,28631972,28631872,200
14111,3484000,2,2203644,2203700,2203672,56
14112,3484000,3,17988823,17988984,17988903,161
14113,3484000,3,18372141,18373620,18372880,1479
14114,3484000,4,10482039,10482149,10482094,110
14115,3484000,5,5610904,5611794,5611349,890
14116,3484000,5,6283988,6284078,6284033,90
14117,3484000,5,15748435,15748466,15748450,31
14118,3484001,1,8915604,8915789,8915696,185
14119,3484001,1,16482974,16484852,16483913,1878
14120,3484001,1,17240124,17240210,17240167,86
14121,3484001,2,758530,759010,758770,480
14122,3484001,2,7631299,7631650,7631474,351
14123,3484001,3,2890446,2890746,2890596,300
14124,3484001,3,10903075,10903141,10903108,66
14125,3484001,4,5726186,5729491,5727838,3305
14126,3484001,4,11743706,11743712,11743709,6
14127,3484001,5,6732957,6734754,6733855,1797
14128,3484001,5,26226132,26226798,26226465,666
14129,3484002,1,591513,593981,592747,2468
14130,3484002,1,26262231,26262402,26262316,171
14131,3484002,2,1073125,1073206,1073165,81
14132,3484002,2,11849462,11853169,11851315,3707
14133,3484002,2,17415922,17416053,17415987,131
14134,3484002,3,18876025,18876151,18876088,126
14135,3484002,4,14995003,14996251,14995627,1248
14136,3484002,4,17476622,17477717,17477169,1095
14137,3484002,5,17165164,17165558,17165361,394
14138,3484002,5,20097073,20097082,20097077,9
14139,3484003,1,7906505,7907866,7907185,1361
14140,3484003,1,29234220,29234249,29234234,29
14141,3484003,2,1554369,1554519,1554444,150
14142,3484003,2,9910587,9911024,9910805,437
14143,3484003,4,14953490,14955969,14954729,2479
14144,3484003,5,361701,362167,361934,466
14145,3484003,5,26515178,26515905,26515541,727
14146,3484004,1,842620,844066,843343,1446
14147,3484004,1,7829473,7829563,7829518,90
14148,3484004,1,17472857,17473306,17473081,449
14149,3484004,1,30344898,30345138,30345018,240
14150,3484004,2,7005578,7005813,7005695,235
14151,3484004,3,7599302,7600145,7599723,843
14152,3484004,3,8679908,8681975,8680941,2067
14153,3484004,3,21264595,21264795,21264695,200
14154,3484004,4,12350953,12351783,12351368,830
14155,3484004,4,14127297,14127359,14127328,62
14156,3484004,5,13776333,13776360,13776346,27
14157,3484004,5,18469922,18470354,18470138,432
14158,3484004,5,24238788,24239998,24239393,1210
14159,3484005,1,7849587,7850674,7850130,1087
14160,3484005,2,498578,499423,499000,845
14161,3484005,2,17474376,17475447,17474911,1071
14162,3484005,3,17494360,17494414,17494387,54
14163,3484005,4,10136941,10137549,10137245,608
14164,3484005,4,14061470,14061581,14061525,111
14165,3484005,4,17654284,17654398,17654341,114
14166,3484005,5,8580851,8581660,8581255,809
14167,3484006,1,13030601,13033405,13032003,2804
14168,3484006,2,9896737,9897871,9897304,1134
14169,3484006,2,17744037,17746046,17745041,2009
14170,3484006,3,17472498,17472637,17472567,139
14171,3484006,3,21211170,21212292,21211731,1122
14172,3484006,4,5337911,5337930,5337920,19
14173,3484006,5,6190351,6191387,6190869,1036
14174,3484006,5,22560696,22560770,22560733,74
14175,3484006,5,26290644,26290662,26290653,18
14176,3484007,2,239091,239549,239320,458
14177,3484007,4,9028110,9028245,9028177,135
14178,3484007,4,10607363,10607612,10607487,249
14179,3484007,5,4227870,4229477,4228673,1607
14180,3484007,5,26424506,26424960,26424733,454
14181,3484008,1,558833,562860,560846,4027
14182,3484008,1,11033493,11033646,11033569,153
14183,3484008,2,6649481,6649711,6649596,230
14184,3484008,3,2146221,2147176,2146698,955
14185,3484008,4,11755132,11755161,11755146,29
14186,3484008,5,357442,357447,357444,5
14187,3484008,5,10381451,10381801,10381626,350
14188,3484008,5,24476972,24478649,24477810,1677
14189,3484008,5,26006199,26006910,26006554,711
14190,3484009,1,165059,165910,165484,851
14191,3484009,2,371715,373365,372540,1650
14192,3484009,2,1136759,1136801,1136780,42
14193,3484009,3,2489382,2489965,2489673,583
14194,3484009,3,12575400,12575645,12575522,245
14195,3484009,4,8257801,8258486,8258143,685
14196,3484009,4,17797773,17798409,17798091,636
14197,3484009,5,6043935,6044020,6043977,85
14198,3484009,5,21311656,21311769,21311712,113
14199,3484009,5,21336236,21336265,21336250,29
14200,3484009,5,22534012,22534193,22534102,181
14201,3484010,1,9820128,9820231,9820179,103
14202,3484010,1,27556643,27557588,27557115,945
14203,3484010,4,5765774,5765803,5765788,29
14204,3484010,5,572518,572597,572557,79
14205,3484010,5,8989611,8990695,8990153,1084
14206,3484011,2,16790016,16790146,16790081,130
14207,3484011,3,1223666,1223793,1223729,127
14208,3484011,5,831360,831653,831506,293
14209,3484011,5,8846258,8846590,8846424,332
14210,3484012,1,16981110,16981131,16981120,21
14211,3484012,1,17033410,17033679,17033544,269
14212,3484012,2,4779325,4781682,4780503,2357
14213,3484012,2,12203943,12204252,12204097,309
14214,3484012,3,9062990,9063600,9063295,610
14215,3484012,3,15994063,15994417,15994240,354
14216,3484012,4,8050450,8051498,8050974,1048
14217,3484012,5,18030426,18031065,18030745,639
14218,3484012,5,26135768,26136241,26136004,473
14219,3484013,1,7106852,7108167,7107509,1315
14220,3484013,1,23267646,23267690,23267668,44
14221,3484013,1,30402459,30402571,30402515,112
14222,3484013,2,2897779,2897929,2897854,150
14223,3484013,2,11875505,11876318,11875911,813
14224,3484013,3,8715534,8715825,8715679,291
14225,3484013,3,16897428,16898378,16897903,950
14226,3484013,5,13700003,13700048,13700025,45
14227,3484013,5,24493715,24494049,24493882,334
14228,3484014,1,1163842,1164142,1163992,300
14229,3484014,1,19096085,19096212,19096148,127
14230,3484014,1,26707715,26707843,26707779,128
14231,3484014,1,29368595,29368894,29368744,299
14232,3484014,2,10747899,10747949,10747924,50
14233,3484014,2,16640068,16641687,16640877,1619
14234,3484014,3,19450489,19450696,19450592,207
14235,3484014,5,24758066,24758101,24758083,35
14236,3484014,5,25993429,25995771,25994600,2342
14237,3484015,1,9811149,9811779,9811464,630
14238,3484015,1,27593158,27593692,27593425,534
14239,3484015,4,5743887,5746060,5744973,2173
14240,3484015,5,575349,575916,575632,567
14241,3484015,5,8994905,8995258,8995081,353
14242,3484016,1,10648480,10649620,10649050,1140
14243,3484016,1,28904838,28905429,28905133,591
14244,3484016,2,470969,471211,471090,242
14245,3484016,2,12364001,12364981,12364491,980
14246,3484016,2,12935819,12936731,12936275,912
14247,3484016,3,15606402,15607264,15606833,862
14248,3484016,4,326169,326471,326320,302
14249,3484016,4,11565144,11565229,11565186,85
14250,3484016,5,2927730,2930912,2929321,3182
14251,3484016,5,8043632,8044192,8043912,560
14252,3484016,5,9900751,9901113,9900932,362
14253,3484016,5,22396460,22396598,22396529,138
14254,3484016,5,22859462,22860221,22859841,759
14255,3484016,5,26814639,26815167,26814903,528
14256,3484017,1,13043571,13043638,13043604,67
14257,3484017,1,16564897,16564918,16564907,21
14258,3484017,2,18963855,18964731,18964293,876
14259,3484017,4,8418348,8418476,8418412,128
14260,3484018,1,8009431,8009781,8009606,350
14261,3484018,1,17132260,17134659,17133459,2399
14262,3484018,3,2165429,2165742,2165585,313
14263,3484018,4,7246616,7247349,7246982,733
14264,3484018,5,14975828,14976840,14976334,1012
14265,3484018,5,16890267,16890473,16890370,206
14266,3484018,5,26236082,26236674,26236378,592
14267,3484019,1,7914724,7915244,7914984,520
14268,3484019,1,24853376,24853390,24853383,14
14269,3484019,2,10742147,10742176,10742161,29
14270,3484019,2,11907139,11907623,11907381,484
14271,3484019,3,8120520,8120684,8120602,164
14272,3484019,3,9147808,9147929,9147868,121
14273,3484019,4,587810,587948,587879,138
14274,3484019,4,16829878,16830055,16829966,177
14275,3484019,5,2632691,2632906,2632798,215
14276,3484019,5,10646913,10647089,10647001,176
14277,3484019,5,21229010,21229401,21229205,391
14278,3484020,1,662928,663182,663055,254
14279,3484020,1,10295050,10295819,10295434,769
14280,3484020,1,24040215,24040549,24040382,334
14281,3484020,2,2927023,2927798,2927410,775
14282,3484020,2,18268959,18270379,18269669,1420
14283,3484020,3,6403166,6403982,6403574,816
14284,3484020,3,10879248,10879465,10879356,217
14285,3484020,3,19274416,19274793,19274604,377
14286,3484020,4,6272121,6272582,6272351,461
14287,3484020,5,493967,493986,493976,19
14288,3484020,5,9675552,9675761,9675656,209
14289,3484021,1,7136539,7137061,7136800,522
14290,3484021,1,12922179,12922231,12922205,52
14291,3484021,1,16717376,16717468,16717422,92
14292,3484021,2,6960619,6960832,6960725,213
14293,3484021,2,17003052,17004248,17003650,1196
14294,3484021,2,19406812,19407631,19407221,819
14295,3484021,3,3082166,3082555,3082360,389
14296,3484021,3,16108746,16109155,16108950,409
14297,3484021,3,16949483,16951352,16950417,1869
14298,3484021,4,666853,667414,667133,561
14299,3484021,4,6735570,6736283,6735926,713
14300,3484021,5,13879478,13879520,13879499,42
14301,3484021,5,18671408,18671552,18671480,144
14302,3484022,1,11114322,11116278,11115300,1956
14303,3484022,2,7050545,7052256,7051400,1711
14304,3484022,3,6668816,6668977,6668896,161
14305,3484022,3,19434705,19435503,19435104,798
14306,3484022,5,26836881,26837280,26837080,399
14307,3484023,1,1795160,1797339,1796249,2179
14308,3484023,1,17662660,17662711,17662685,51
14309,3484023,1,28930280,28930646,28930463,366
14310,3484023,2,10224629,10225068,10224848,439
14311,3484023,2,18356967,18357936,18357451,969
14312,3484023,3,21833450,21833719,21833584,269
14313,3484023,4,7249271,7249446,7249358,175
14314,3484023,5,1329987,1335476,1332731,5489
14315,3484024,1,1143782,1143832,1143807,50
14316,3484024,1,4262995,4263173,4263084,178
14317,3484024,1,9095488,9098075,9096781,2587
14318,3484024,1,20968710,20970351,20969530,1641
14319,3484024,2,9645375,9647883,9646629,2508
14320,3484024,3,4962656,4963078,4962867,422
14321,3484024,3,5371646,5373622,5372634,1976
14322,3484024,3,5862101,5862280,5862190,179
14323,3484025,1,2977635,2978310,2977972,675
14324,3484025,1,10630133,10631599,10630866,1466
14325,3484025,1,26449022,26449603,26449312,581
14326,3484025,3,16498088,16498192,16498140,104
14327,3484025,4,7253065,7253320,7253192,255
14328,3484025,5,569982,570137,570059,155
14329,3484026,1,17150549,17154440,17152494,3891
14330,3484026,3,3243455,3244792,3244123,1337
14331,3484026,3,16256462,16256912,16256687,450
14332,3484026,5,3817904,3818040,3817972,136
14333,3484026,5,18699286,18703151,18701218,3865
14334,3484027,1,13227215,13229690,13228452,2475
14335,3484027,1,24249859,24250519,24250189,660
14336,3484027,2,6800934,6802479,6801706,1545
14337,3484027,2,10907173,10907218,10907195,45
14338,3484027,2,13942218,13942333,13942275,115
14339,3484027,3,19911122,19911980,19911551,858
14340,3484027,4,1044393,1045635,1045014,1242
14341,3484027,4,14224594,14225734,14225164,1140
14342,3484027,5,17450379,17450446,17450412,67
14343,3484027,5,18390850,18391104,18390977,254
14344,3484027,5,24240271,24240296,24240283,25
14345,3484028,1,7431890,7432697,7432293,807
14346,3484028,1,9458728,9458756,9458742,28
14347,3484028,1,11026302,11026405,11026353,103
14348,3484028,1,29701067,29701151,29701109,84
14349,3484028,2,1288284,1288419,1288351,135
14350,3484028,2,10177079,10177554,10177316,475
14351,3484028,2,17829729,17829948,17829838,219
14352,3484028,3,6764584,6765356,6764970,772
14353,3484028,3,21032150,21032926,21032538,776
14354,3484028,4,6514619,6514634,6514626,15
14355,3484028,4,13164545,13165709,13165127,1164
14356,3484028,4,14900721,14900825,14900773,104
14357,3484028,5,9404589,9404732,9404660,143
14358,3484028,5,21678608,21678863,21678735,255
14359,3484028,5,22216008,22216145,22216076,137
14360,3484029,1,26031448,26037054,26034251,5606
14361,3484029,3,3051117,3052691,3051904,1574
14362,3484029,3,10180078,10180082,10180080,4
14363,3484029,4,748459,748893,748676,434
14364,3484029,4,5710142,5710434,5710288,292
14365,3484029,4,18294898,18295037,18294967,139
14366,3484029,5,627708,628109,627908,401
14367,3484029,5,8839485,8839564,8839524,79
14368,3484029,5,21896149,21896314,21896231,165
14369,3484030,1,4201590,4201794,4201692,204
14370,3484030,1,16472503,16472561,16472532,58
14371,3484030,1,29065493,29066463,29065978,970
14372,3484030,2,652891,653669,653280,778
14373,3484030,3,1018761,1018831,1018796,70
14374,3484030,3,10718889,10718945,10718917,56
14375,3484030,4,6397710,6398117,6397913,407
14376,3484030,4,6717709,6718260,6717984,551
14377,3484030,4,17398129,17398846,17398487,717
14378,3484030,5,10262017,10262208,10262112,191
14379,3484030,5,22333186,22334204,22333695,1018
14380,3484030,5,23092187,23092696,23092441,509
14381,3484031,1,1371590,1372058,1371824,468
14382,3484031,1,18293445,18294119,18293782,674
14383,3484031,2,2910299,2910566,2910432,267
14384,3484031,2,11144387,11146309,11145348,1922
14385,3484031,2,18845967,18846091,18846029,124
14386,3484032,1,25379938,25380008,25379973,70
14387,3484032,2,5937080,5937140,5937110,60
14388,3484032,3,9305775,9305911,9305843,136
14389,3484032,4,7738642,7739905,7739273,1263
14390,3484032,4,10340023,10340252,10340137,229
14391,3484032,5,5746532,5747697,5747114,1165
14392,3484032,5,17098475,17098565,17098520,90
14393,3484032,5,20077031,20077055,20077043,24
14394,3484032,5,21868801,21869285,21869043,484
14395,3484033,1,12602187,12602637,12602412,450
14396,3484033,2,8560981,8560982,8560981,1
14397,3484033,3,2155343,2155501,2155422,158
14398,3484033,3,16966210,16966518,16966364,308
14399,3484033,4,11760013,11760276,11760144,263
14400,3484033,5,18006040,18006503,18006271,463
14401,3484033,5,25418538,25419018,25418778,480
14402,3484034,1,22801969,22802181,22802075,212
14403,3484034,2,12151458,12151657,12151557,199
14404,3484034,3,10351123,10351284,10351203,161
14405,3484034,3,10923253,10923576,10923414,323
14406,3484034,4,5490625,5494879,5492752,4254
14407,3484034,5,14528402,14529534,14528968,1132
14408,3484035,1,10213917,10214215,10214066,298
14409,3484035,1,10944048,10945243,10944645,1195
14410,3484035,1,25165851,25166721,25166286,870
14411,3484035,2,5689965,5690028,5689996,63
14412,3484035,2,9374709,9375100,9374904,391
14413,3484036,1,179175,179753,179464,578
14414,3484036,1,29201871,29201989,29201930,118
14415,3484036,2,9984822,9985388,9985105,566
14416,3484036,2,16810726,16811728,16811227,1002
14417,3484036,3,4648443,4650526,4649484,2083
14418,3484036,4,511091,511751,511421,660
14419,3484036,4,10168920,10168972,10168946,52
14420,3484036,5,2105239,2105367,2105303,128
14421,3484036,5,15818384,15822045,15820214,3661
14422,3484037,1,484340,485242,484791,902
14423,3484037,1,24407561,24407670,24407615,109
14424,3484037,1,25660901,25663015,25661958,2114
14425,3484037,2,9315730,9315732,9315731,2
14426,3484037,2,19179687,19181516,19180601,1829
14427,3484037,3,10893129,10893202,10893165,73
14428,3484037,4,7757025,7757989,7757507,964
14429,3484037,4,16478701,16478836,16478768,135
14430,3484038,1,16132479,16132662,16132570,183
14431,3484038,2,163182,163192,163187,10
14432,3484038,2,16273446,16273595,16273520,149
14433,3484038,3,10837841,10839158,10838499,1317
14434,3484038,4,390454,390891,390672,437
14435,3484038,4,5196581,5196870,5196725,289
14436,3484038,5,1907800,1909113,1908456,1313
14437,3484038,5,16546170,16546450,16546310,280
14438,3484039,1,22003243,22003326,22003284,83
14439,3484039,1,25768460,25770401,25769430,1941
14440,3484039,2,15790515,15791152,15790833,637
14441,3484039,3,9856580,9857087,9856833,507
14442,3484039,3,11107805,11108169,11107987,364
14443,3484039,4,9288965,9289392,9289178,427
14444,3484039,5,10291394,10291541,10291467,147
14445,3484040,1,166830,166850,166840,20
14446,3484040,1,4533378,4533829,4533603,451
14447,3484040,1,7060289,7060699,7060494,410
14448,3484040,2,1840663,1840708,1840685,45
14449,3484040,2,19019418,19020450,19019934,1032
14450,3484040,3,7934768,7934882,7934825,114
14451,3484040,5,3104545,3104602,3104573,57
14452,3484040,5,22201249,22201322,22201285,73
14453,3484041,1,387834,387895,387864,61
14454,3484041,1,7825561,7825585,7825573,24
14455,3484041,2,7817326,7817967,7817646,641
14456,3484041,2,15644515,15645515,15645015,1000
14457,3484041,3,7571913,7572383,7572148,470
14458,3484041,3,17998923,17998989,17998956,66
14459,3484041,3,19445725,19445781,19445753,56
14460,3484041,4,10107704,10107886,10107795,182
14461,3484041,5,18663893,18665450,18664671,1557
14462,3484041,5,23837532,23837683,23837607,151
14463,3484042,1,16130483,16130498,16130490,15
14464,3484042,1,27702819,27702906,27702862,87
14465,3484042,2,7292331,7292485,7292408,154
14466,3484042,3,11839966,11840052,11840009,86
14467,3484042,3,18821782,18823677,18822729,1895
14468,3484042,4,7366654,7367050,7366852,396
14469,3484042,4,15640591,15642684,15641637,2093
14470,3484042,5,7265308,7268151,7266729,2843
14471,3484042,5,21657519,21658024,21657771,505
14472,3484043,1,5194015,5194740,5194377,725
14473,3484043,1,7731429,7731453,7731441,24
14474,3484043,1,29079975,29080683,29080329,708
14475,3484043,2,479644,480287,479965,643
14476,3484043,3,15866212,15866464,15866338,252
14477,3484043,4,383239,383308,383273,69
14478,3484043,4,7494764,7494830,7494797,66
14479,3484043,4,17362722,17364827,17363774,2105
14480,3484043,5,9296241,9299099,9297670,2858
14481,3484044,1,3246984,3247933,3247458,949
14482,3484044,1,21016801,21018431,21017616,1630
14483,3484044,3,2302744,2303067,2302905,323
14484,3484044,3,7477362,7477552,7477457,190
14485,3484044,3,10887330,10887554,10887442,224
14486,3484044,3,20608473,20610256,20609364,1783
14487,3484044,4,12496360,12497385,12496872,1025
14488,3484044,4,18312936,18312992,18312964,56
14489,3484044,5,7871119,7871391,7871255,272
14490,3484045,1,11667109,11672203,11669656,5094
14491,3484045,1,18402234,18403169,18402701,935
14492,3484045,1,19467905,19468795,19468350,890
14493,3484045,2,1024792,1024829,1024810,37
14494,3484045,3,10587310,10587469,10587389,159
14495,3484045,3,10802347,10803624,10802985,1277
14496,3484045,3,17796257,17798403,17797330,2146
14497,3484045,4,17614034,17615121,17614577,1087
14498,3484045,5,5286080,5286107,5286093,27
14499,3484045,5,14014530,14015364,14014947,834
14500,3484045,5,17508846,17509054,17508950,208
14501,3484045,5,25983066,25983404,25983235,338
14502,3484046,1,9151164,9152328,9151746,1164
14503,3484046,1,20813412,20813418,20813415,6
14504,3484046,3,2207658,2207838,2207748,180
14505,3484046,4,523488,523917,523702,429
14506,3484046,4,799356,799424,799390,68
14507,3484046,4,11637051,11637637,11637344,586
14508,3484046,5,2180196,2180240,2180218,44
14509,3484046,5,10458893,10459257,10459075,364
14510,3484047,1,9847834,9848816,9848325,982
14511,3484047,1,17283163,17283282,17283222,119
14512,3484047,2,989642,989807,989724,165
14513,3484047,3,9496157,9497318,9496737,1161
14514,3484047,3,10224350,10224631,10224490,281
14515,3484047,5,2432350,2432362,2432356,12
14516,3484047,5,7271121,7272646,7271883,1525
14517,3484048,1,18595322,18595390,18595356,68
14518,3484048,2,10399800,10400855,10400327,1055
14519,3484048,3,3351482,3352190,3351836,708
14520,3484048,3,10331790,10331811,10331800,21
14521,3484048,3,12693505,12693554,12693529,49
14522,3484048,3,14764398,14764477,14764437,79
14523,3484048,4,13711071,13711743,13711407,672
14524,3484048,5,13588813,13589062,13588937,249
14525,3484049,1,12284750,12286259,12285504,1509
14526,3484049,1,29811357,29811867,29811612,510
14527,3484049,2,5936340,5936992,5936666,652
14528,3484049,2,13857070,13857099,13857084,29
14529,3484049,3,15658296,15658622,15658459,326
14530,3484049,3,20758022,20758181,20758101,159
14531,3484049,4,8562183,8562287,8562235,104
14532,3484049,5,4007116,4007600,4007358,484
14533,3484049,5,17179042,17179065,17179053,23
14534,3484049,5,24393838,24395666,24394752,1828
14535,3484050,1,569887,570157,570022,270
14536,3484050,1,11812270,11812524,11812397,254
14537,3484050,1,22980034,22981167,22980600,1133
14538,3484050,1,29274460,29274583,29274521,123
14539,3484050,2,1152875,1152952,1152913,77
14540,3484050,2,9563004,9563549,9563276,545
14541,3484050,2,19019275,19020654,19019964,1379
14542,3484050,3,11510424,11510542,11510483,118
14543,3484050,4,17509736,17510447,17510091,711
14544,3484050,5,9136315,9137938,9137126,1623
14545,3484050,5,26361160,26361272,26361216,112
14546,3484051,1,20423771,20424545,20424158,774
14547,3484051,1,30413724,30414080,30413902,356
14548,3484051,3,4556531,4558614,4557572,2083
14549,3484051,3,22711086,22711883,22711484,797
14550,3484051,4,7808014,7808535,7808274,521
14551,3484051,4,8985235,8985512,8985373,277
14552,3484051,4,15859785,15859906,15859845,121
14553,3484051,5,184255,184734,184494,479
14554,3484051,5,16942905,16943203,16943054,298
14555,3484051,5,18931570,18932633,18932101,1063
14556,3484051,5,24962318,24962363,24962340,45
14557,3484052,1,29485540,29486081,29485810,541
14558,3484052,2,7045036,7046890,7045963,1854
14559,3484052,2,18201848,18201915,18201881,67
14560,3484052,3,5577309,5577415,5577362,106
14561,3484052,4,7854243,7855899,7855071,1656
14562,3484052,5,809205,809231,809218,26
14563,3484052,5,8848532,8848670,8848601,138
14564,3484052,5,17090238,17090571,17090404,333
14565,3484053,1,8574816,8576111,8575463,1295
14566,3484053,2,861023,861035,861029,12
14567,3484053,3,861548,866910,864229,5362
14568,3484053,3,16551023,16551061,16551042,38
14569,3484053,4,7216216,7216274,7216245,58
14570,3484053,5,8747124,8747249,8747186,125
14571,3484053,5,25467531,25467830,25467680,299
14572,3484054,3,4517672,4517981,4517826,309
14573,3484054,5,6045526,6046152,6045839,626
14574,3484054,5,14644953,14648303,14646628,3350
14575,3484054,5,21312780,21312979,21312879,199
14576,3484055,3,8167524,8174634,8171079,7110
14577,3484055,3,15514915,15516349,15515632,1434
14578,3484055,4,2062,2162,2112,100
14579,3484055,4,7174465,7174587,7174526,122
14580,3484055,4,11760276,11760852,11760564,576
14581,3484055,5,15623290,15626318,15624804,3028
14582,3484055,5,23643339,23644502,23643920,1163
14583,3484056,1,4545675,4546171,4545923,496
14584,3484056,1,26796705,26797028,26796866,323
14585,3484056,3,16723680,16725340,16724510,1660
14586,3484056,3,21344192,21344342,21344267,150
14587,3484056,4,36949,37226,37087,277
14588,3484056,4,16823153,16823236,16823194,83
14589,3484056,5,398651,399011,398831,360
14590,3484056,5,5260328,5260896,5260612,568
14591,3484056,5,14958589,14958789,14958689,200
14592,3484056,5,25645956,25646145,25646050,189
14593,3484057,1,11057818,11058094,11057956,276
14594,3484057,1,16076080,16076190,16076135,110
14595,3484057,1,23656048,23656694,23656371,646
14596,3484057,2,12986516,12986575,12986545,59
14597,3484057,3,10403175,10403357,10403266,182
14598,3484057,3,15746278,15746355,15746316,77
14599,3484057,4,6364753,6364893,6364823,140
14600,3484057,4,9445853,9446530,9446191,677
14601,3484057,4,17633509,17635430,17634469,1921
14602,3484057,5,10814372,10814695,10814533,323
14603,3484057,5,21120766,21120893,21120829,127
14604,3484058,1,3672441,3674112,3673276,1671
14605,3484058,1,12177220,12178208,12177714,988
14606,3484058,1,23511123,23513942,23512532,2819
14607,3484058,1,25765142,25765427,25765284,285
14608,3484058,2,6732247,6732274,6732260,27
14609,3484058,2,12765805,12765991,12765898,186
14610,3484058,4,5699551,5699654,5699602,103
14611,3484058,4,7723382,7724510,7723946,1128
14612,3484058,5,18849530,18849827,18849678,297
14613,3484059,1,2706147,2706180,2706163,33
14614,3484059,2,8549594,8551940,8550767,2346
14615,3484059,2,9689203,9689246,9689224,43
14616,3484059,3,7841957,7842914,7842435,957
14617,3484059,3,21599287,21599862,21599574,575
14618,3484059,4,1509585,1509912,1509748,327
14619,3484059,5,26171691,26171731,26171711,40
14620,3484060,1,25511836,25518967,25515401,7131
14621,3484060,2,2322170,2323274,2322722,1104
14622,3484060,2,9758088,9759631,9758859,1543
14623,3484060,3,5375432,5375658,5375545,226
14624,3484060,3,10360668,10360816,10360742,148
14625,3484060,3,18533569,18534676,18534122,1107
14626,3484060,5,7550284,7550436,7550360,152
14627,3484060,5,16123131,16123947,16123539,816
14628,3484061,1,23997229,23997820,23997524,591
14629,3484061,2,5666255,5666372,5666313,117
14630,3484061,2,12443436,12443489,12443462,53
14631,3484061,3,7597962,7598037,7597999,75
14632,3484061,3,18672134,18674092,18673113,1958
14633,3484061,4,8431174,8431202,8431188,28
14634,3484061,4,15704384,15705031,15704707,647
14635,3484061,4,18416501,18416505,18416503,4
14636,3484061,5,10923322,10924400,10923861,1078
14637,3484061,5,21081783,21082280,21082031,497
14638,3484061,5,22259361,22259859,22259610,498
14639,3484062,1,1072172,1072314,1072243,142
14640,3484062,1,28706146,28707111,28706628,965
14641,3484062,2,6174153,6174346,6174249,193
14642,3484062,2,15507759,15507818,15507788,59
14643,3484062,3,3042990,3043029,3043009,39
14644,3484062,3,11199884,11200225,11200054,341
14645,3484062,4,13510411,13510822,13510616,411
14646,3484062,5,1206158,1206284,1206221,126
14647,3484062,5,20553052,20555846,20554449,2794
14648,3484062,5,23336319,23337120,23336719,801
14649,3484063,1,2393231,2393259,2393245,28
14650,3484063,1,9896116,9896702,9896409,586
14651,3484063,1,13317896,13318349,13318122,453
14652,3484063,1,21081871,21081911,21081891,40
14653,3484063,1,27646135,27646255,27646195,120
14654,3484063,2,9051227,9051370,9051298,143
14655,3484063,3,1250947,1250955,1250951,8
14656,3484063,3,15880704,15880765,15880734,61
14657,3484063,3,17991215,17991320,17991267,105
14658,3484063,4,5840295,5840587,5840441,292
14659,3484063,5,14972542,14974529,14973535,1987
14660,3484063,5,20877481,20877527,20877504,46
14661,3484064,1,2521379,2523346,2522362,1967
14662,3484064,1,19046794,19047007,19046900,213
14663,3484064,1,24796230,24796453,24796341,223
14664,3484064,2,9539663,9539834,9539748,171
14665,3484064,2,14522366,14522373,14522369,7
14666,3484064,3,11717729,11718711,11718220,982
14667,3484064,3,16473266,16473592,16473429,326
14668,3484064,5,15823865,15824063,15823964,198
14669,3484064,5,24476204,24476964,24476584,760
14670,3484065,1,1424044,1424237,1424140,193
14671,3484065,1,16880370,16880531,16880450,161
14672,3484065,1,17252628,17252669,17252648,41
14673,3484065,2,6669063,6670192,6669627,1129
14674,3484065,2,7811358,7811520,7811439,162
14675,3484065,3,22790405,22790425,22790415,20
14676,3484065,4,9594069,9594161,9594115,92
14677,3484065,4,10279315,10279732,10279523,417
14678,3484065,5,1417550,1417648,1417599,98
14679,3484065,5,6050264,6052126,6051195,1862
14680,3484065,5,25114352,25115903,25115127,1551
14681,3484066,1,28520086,28521846,28520966,1760
14682,3484066,1,30415213,30416373,30415793,1160
14683,3484066,3,19654748,19655093,19654920,345
14684,3484066,4,1209589,1209635,1209612,46
14685,3484066,4,17736024,17736287,17736155,263
14686,3484066,5,2940528,2942542,2941535,2014
14687,3484067,1,16782253,16782430,16782341,177
14688,3484067,3,2981538,2982240,2981889,702
14689,3484067,3,16168993,16170125,16169559,1132
14690,3484067,4,5790853,5791715,5791284,862
14691,3484067,4,18172746,18172771,18172758,25
14692,3484067,5,5753235,5753416,5753325,181
14693,3484067,5,9084869,9085437,9085153,568
14694,3484067,5,16773506,16773542,16773524,36
14695,3484068,2,188633,189081,188857,448
14696,3484068,2,10209320,10211118,10210219,1798
14697,3484068,3,10743326,10744809,10744067,1483
14698,3484068,4,4196390,4196647,4196518,257
14699,3484068,4,14806853,14807177,14807015,324
14700,3484068,5,7466506,7466847,7466676,341
14701,3484068,5,23832212,23832485,23832348,273
14702,3484069,1,13455443,13455523,13455483,80
14703,3484069,2,9751078,9751251,9751164,173
14704,3484069,3,1171530,1172014,1171772,484
14705,3484069,4,1439945,1440963,1440454,1018
14706,3484069,4,10940540,10940569,10940554,29
14707,3484069,5,25981254,25981568,25981411,314
14708,3484070,1,10877358,10877690,10877524,332
14709,3484070,2,12150302,12150363,12150332,61
14710,3484070,5,7270746,7270950,7270848,204
14711,3484070,5,7367489,7367827,7367658,338
14712,3484070,5,14736736,14737090,14736913,354
14713,3484071,1,1221514,1222326,1221920,812
14714,3484071,1,7046901,7047568,7047234,667
14715,3484071,1,9095488,9098075,9096781,2587
14716,3484071,1,26389294,26389344,26389319,50
14717,3484071,2,15598212,15598331,15598271,119
14718,3484071,3,3576277,3576533,3576405,256
14719,3484071,3,11838172,11838476,11838324,304
14720,3484071,4,6213671,6213757,6213714,86
14721,3484071,4,8628705,8628750,8628727,45
14722,3484071,4,9989752,9991654,9990703,1902
14723,3484071,5,6398497,6398601,6398549,104
14724,3484072,1,17244807,17247480,17246143,2673
14725,3484072,2,6641434,6641924,6641679,490
14726,3484072,2,13016521,13017309,13016915,788
14727,3484072,3,3348097,3348657,3348377,560
14728,3484072,3,10885839,10885966,10885902,127
14729,3484072,3,21057441,21059262,21058351,1821
14730,3484072,5,716202,716439,716320,237
14731,3484073,1,16432162,16435132,16433647,2970
14732,3484073,1,29500151,29500664,29500407,513
14733,3484073,2,7292705,7292840,7292772,135
14734,3484073,2,9899115,9900298,9899706,1183
14735,3484073,2,18905078,18905954,18905516,876
14736,3484073,3,3527521,3527534,3527527,13
14737,3484073,3,9875257,9882434,9878845,7177
14738,3484073,5,2073889,2074814,2074351,925
14739,3484073,5,21320549,21321020,21320784,471
14740,3484073,5,21873914,21874268,21874091,354
14741,3484073,5,23835884,23836142,23836013,258
14742,3484074,1,4166784,4167179,4166981,395
14743,3484074,1,21465997,21466232,21466114,235
14744,3484074,1,23082787,23083383,23083085,596
14745,3484074,2,15783020,15783144,15783082,124
14746,3484074,4,7606189,7606408,7606298,219
14747,3484074,5,8692939,8695591,8694265,2652
14748,3484074,5,20256041,20256084,20256062,43
14749,3484074,5,26921507,26921637,26921572,130
14750,3484075,1,13076966,13077108,13077037,142
14751,3484075,1,24044593,24044635,24044614,42
14752,3484075,2,227342,227811,227576,469
14753,3484075,2,12931927,12932451,12932189,524
14754,3484075,2,16009718,16012699,16011208,2981
14755,3484075,3,91077,94156,92616,3079
14756,3484075,3,1266836,1268962,1267899,2126
14757,3484075,3,20457008,20459414,20458211,2406
14758,3484075,4,7353489,7353572,7353530,83
14759,3484075,4,17954424,17955293,17954858,869
14760,3484075,5,5586688,5587539,5587113,851
14761,3484075,5,14998663,14999126,14998894,463
14762,3484076,1,24407242,24407561,24407401,319
14763,3484076,2,688818,689391,689104,573
14764,3484076,2,7033818,7035036,7034427,1218
14765,3484076,3,1353218,1353868,1353543,650
14766,3484076,5,14009551,14009659,14009605,108
14767,3484076,5,18159109,18159149,18159129,40
14768,3484077,1,17252628,17253368,17252998,740
14769,3484077,2,429190,431023,430106,1833
14770,3484077,2,1534249,1535591,1534920,1342
14771,3484077,5,14531492,14531573,14531532,81
14772,3484077,5,18621259,18622381,18621820,1122
14773,3484078,2,6810782,6810947,6810864,165
14774,3484078,2,13972843,13973194,13973018,351
14775,3484078,3,4987727,4988187,4987957,460
14776,3484078,3,8533235,8533768,8533501,533
14777,3484078,3,18038922,18038924,18038923,2
14778,3484078,5,2557990,2559176,2558583,1186
14779,3484078,5,9075604,9076436,9076020,832
14780,3484078,5,25431795,25432171,25431983,376
14781,3484079,1,3448515,3449328,3448921,813
14782,3484079,1,17253829,17254400,17254114,571
14783,3484079,2,358480,358813,358646,333
14784,3484079,2,7757430,7757517,7757473,87
14785,3484079,4,1225999,1226119,1226059,120
14786,3484080,1,7819181,7819562,7819371,381
14787,3484080,1,10413189,10413241,10413215,52
14788,3484080,1,23147017,23147948,23147482,931
14789,3484080,1,26730128,26730204,26730166,76
14790,3484080,2,6517812,6518045,6517928,233
14791,3484080,2,10872360,10882779,10877569,10419
14792,3484080,3,1111386,1111507,1111446,121
14793,3484080,3,3990792,3991379,3991085,587
14794,3484080,5,8185750,8185920,8185835,170
14795,3484080,5,10617373,10618923,10618148,1550
14796,3484080,5,19879617,19880561,19880089,944
14797,3484080,5,23337120,23337310,23337215,190
14798,3484081,1,458079,462849,460464,4770
14799,3484081,1,10378292,10378887,10378589,595
14800,3484081,1,21412884,21413162,21413023,278
14801,3484081,1,29340090,29341009,29340549,919
14802,3484081,2,296799,298576,297687,1777
14803,3484081,2,10202320,10202560,10202440,240
14804,3484081,3,2339666,2339825,2339745,159
14805,3484081,5,10497251,10497583,10497417,332
14806,3484081,5,14122325,14122363,14122344,38
14807,3484082,1,9828522,9828545,9828533,23
14808,3484082,1,22168924,22169669,22169296,745
14809,3484082,1,26595472,26595758,26595615,286
14810,3484082,2,12291265,12292098,12291681,833
14811,3484082,3,5428338,5428539,5428438,201
14812,3484082,3,16491009,16491831,16491420,822
14813,3484082,4,731447,732634,732040,1187
14814,3484082,5,7177646,7178907,7178276,1261
14815,3484082,5,8236764,8236811,8236787,47
14816,3484082,5,17037099,17038118,17037608,1019
14817,3484082,5,25997171,25997418,25997294,247
14818,3484083,1,1940220,1940982,1940601,762
14819,3484083,1,16657766,16657919,16657842,153
14820,3484083,1,30127148,30127230,30127189,82
14821,3484083,2,7384536,7384932,7384734,396
14822,3484083,2,16715198,16715622,16715410,424
14823,3484083,2,18646349,18646358,18646353,9
14824,3484083,3,293639,294337,293988,698
14825,3484083,3,17495672,17496170,17495921,498
14826,3484083,3,20315010,20317049,20316029,2039
14827,3484083,5,61236,63408,62322,2172
14828,3484083,5,1605744,1606046,1605895,302
14829,3484083,5,16391626,16391952,16391789,326
14830,3484083,5,23404968,23405643,23405305,675
14831,3484084,2,10149365,10149488,10149426,123
14832,3484084,3,6785575,6786085,6785830,510
14833,3484084,3,10056983,10057531,10057257,548
14834,3484084,4,5300252,5301062,5300657,810
14835,3484084,5,21615734,21615955,21615844,221
14836,3484084,5,23091581,23092117,23091849,536
14837,3484084,5,23895197,23895304,23895250,107
14838,3484085,1,7706651,7708394,7707522,1743
14839,3484085,2,462521,464312,463416,1791
14840,3484085,2,12169596,12170189,12169892,593
14841,3484085,2,17474265,17475447,17474856,1182
14842,3484085,2,18340962,18341054,18341008,92
14843,3484085,3,8237061,8237095,8237078,34
14844,3484085,3,10142759,10142871,10142815,112
14845,3484085,4,6360181,6360225,6360203,44
14846,3484085,5,17711374,17711512,17711443,138
14847,3484086,1,22585003,22585044,22585023,41
14848,3484086,2,469117,469236,469176,119
14849,3484086,2,17406129,17407658,17406893,1529
14850,3484086,2,17977827,17978204,17978015,377
14851,3484086,3,930409,931430,930919,1021
14852,3484086,3,10489162,10489647,10489404,485
14853,3484086,3,10895480,10896056,10895768,576
14854,3484086,3,12354859,12355201,12355030,342
14855,3484086,3,14878703,14878821,14878762,118
14856,3484086,3,22813158,22813269,22813213,111
14857,3484086,4,11628431,11630424,11629427,1993
14858,3484086,5,1262910,1263028,1262969,118
14859,3484086,5,17570884,17571031,17570957,147
14860,3484086,5,26714020,26714083,26714051,63
14861,3484087,1,2556999,2557081,2557040,82
14862,3484087,1,11196183,11196331,11196257,148
14863,3484087,1,23473193,23473246,23473219,53
14864,3484087,3,2380463,2380835,2380649,372
14865,3484087,3,5156118,5156156,5156137,38
14866,3484087,3,19553141,19553492,19553316,351
14867,3484087,4,315578,315718,315648,140
14868,3484087,4,10400784,10400882,10400833,98
14869,3484087,5,17505781,17506179,17505980,398
14870,3484088,1,6697625,6698746,6698185,1121
14871,3484088,1,10313187,10313589,10313388,402
14872,3484088,1,19461023,19467905,19464464,6882
14873,3484088,4,1157489,1157521,1157505,32
14874,3484088,5,3496749,3497279,3497014,530
14875,3484088,5,9156707,9156888,9156797,181
14876,3484089,1,11108609,11108858,11108733,249
14877,3484089,1,26339156,26340843,26339999,1687
14878,3484089,2,7520287,7520297,7520292,10
14879,3484089,3,3461661,3462047,3461854,386
14880,3484089,4,6092563,6092786,6092674,223
14881,3484089,5,9635983,9635998,9635990,15
14882,3484089,5,10636349,10636740,10636544,391
14883,3484089,5,25942065,25942775,25942420,710
14884,3484090,2,8232352,8233160,8232756,808
14885,3484090,2,9540969,9541253,9541111,284
14886,3484090,3,15743953,15744059,15744006,106
14887,3484090,4,925690,926452,926071,762
14888,3484090,4,11287098,11287225,11287161,127
14889,3484090,5,15259333,15259365,15259349,32
14890,3484091,1,1072172,1072314,1072243,142
14891,3484091,1,10120310,10121823,10121066,1513
14892,3484091,2,624249,624260,624254,11
14893,3484091,2,10795050,10796101,10795575,1051
14894,3484091,4,10365037,10365659,10365348,622
14895,3484091,4,12697666,12700078,12698872,2412
14896,3484091,5,1603774,1604221,1603997,447
14897,3484091,5,6652864,6653056,6652960,192
14898,3484091,5,23418488,23419834,23419161,1346
14899,3484092,1,1162222,1163523,1162872,1301
14900,3484092,1,23330912,23330965,23330938,53
14901,3484092,1,24211980,24212008,24211994,28
14902,3484092,2,7721440,7721603,7721521,163
14903,3484092,2,13375189,13375581,13375385,392
14904,3484092,2,19173201,19173386,19173293,185
14905,3484092,3,1516972,1522032,1519502,5060
14906,3484092,4,18075652,18077093,18076372,1441
14907,3484092,5,7526973,7526976,7526974,3
14908,3484093,1,6958060,6958749,6958404,689
14909,3484093,1,29436063,29436176,29436119,113
14910,3484093,2,10840357,10840381,10840369,24
14911,3484093,3,5244782,5244845,5244813,63
14912,3484093,3,6229529,6230100,6229814,571
14913,3484093,3,16767292,16768551,16767921,1259
14914,3484093,5,584320,585782,585051,1462
14915,3484093,5,14713372,14714187,14713779,815
14916,3484093,5,19796113,19797294,19796703,1181
14917,3484093,5,21801634,21802085,21801859,451
14918,3484094,1,12711685,12711689,12711687,4
14919,3484094,1,16868980,16869025,16869002,45
14920,3484094,2,9908444,9908718,9908581,274
14921,3484094,3,22942047,22942416,22942231,369
14922,3484094,4,963383,969995,966689,6612
14923,3484094,4,10372117,10373938,10373027,1821
14924,3484094,5,10397193,10397422,10397307,229
14925,3484094,5,16610509,16610613,16610561,104
14926,3484094,5,20789074,20789453,20789263,379
14927,3484095,1,2754492,2754637,2754564,145
14928,3484095,1,3566053,3567037,3566545,984
14929,3484095,2,1056377,1056645,1056511,268
14930,3484095,3,10802347,10802526,10802436,179
14931,3484095,4,8194027,8195652,8194839,1625
14932,3484096,1,12917740,12918082,12917911,342
14933,3484096,1,23446473,23446477,23446475,4
14934,3484096,2,7947116,7947191,7947153,75
14935,3484096,2,18599987,18600382,18600184,395
14936,3484096,3,15501578,15501702,15501640,124
14937,3484096,3,15774855,15777075,15775965,2220
14938,3484096,4,1569396,1569526,1569461,130
14939,3484096,5,7201300,7202884,7202092,1584
14940,3484096,5,9458251,9459538,9458894,1287
14941,3484097,1,650855,652281,651568,1426
14942,3484097,1,23247953,23248584,23248268,631
14943,3484097,1,27672502,27672867,27672684,365
14944,3484097,2,6244110,6245071,6244590,961
14945,3484097,2,11678812,11678840,11678826,28
14946,3484097,3,3666785,3669247,3668016,2462
14947,3484097,3,8237733,8240796,8239264,3063
14948,3484097,3,16471602,16471765,16471683,163
14949,3484097,4,1377898,1377964,1377931,66
14950,3484097,4,6194638,6197297,6195967,2659
14951,3484097,5,569982,570137,570059,155
14952,3484097,5,4983638,4984853,4984245,1215
14953,3484097,5,7902859,7902871,7902865,12
14954,3484098,1,12333570,12338521,12336045,4951
14955,3484098,1,13142529,13142639,13142584,110
14956,3484098,3,1527718,1529607,1528662,1889
14957,3484098,3,5325332,5325842,5325587,510
14958,3484098,4,5297088,5297434,5297261,346
14959,3484098,5,22100357,22101232,22100794,875
14960,3484099,1,13075442,13076724,13076083,1282
14961,3484099,1,19367238,19367682,19367460,444
14962,3484099,3,15906005,15906538,15906271,533
14963,3484099,3,18885170,18885425,18885297,255
14964,3484099,4,7794497,7794597,7794547,100
14965,3484099,5,20778033,20778854,20778443,821
14966,3484100,1,7907931,7907994,7907962,63
14967,3484100,1,19519888,19522177,19521032,2289
14968,3484100,2,6032905,6032921,6032913,16
14969,3484100,4,1023562,1026302,1024932,2740
14970,3484100,4,6787896,6788104,6788000,208
14971,3484100,4,17474011,17476038,17475024,2027
14972,3484100,5,8893444,8895846,8894645,2402
14973,3484100,5,22047246,22047965,22047605,719
14974,3484101,1,2521379,2524032,2522705,2653
14975,3484101,1,21469938,21470094,21470016,156
14976,3484101,1,26240886,26241078,26240982,192
14977,3484101,1,29261820,29262189,29262004,369
14978,3484101,2,11150171,11150413,11150292,242
14979,3484101,3,2347347,2347641,2347494,294
14980,3484101,3,23181257,23181284,23181270,27
14981,3484101,4,1635613,1635731,1635672,118
14982,3484101,4,12477958,12479400,12478679,1442
14983,3484101,5,7826741,7827278,7827009,537
14984,3484102,1,2036861,2038799,2037830,1938
14985,3484102,1,12711704,12711885,12711794,181
14986,3484102,3,5322885,5325046,5323965,2161
14987,3484102,3,10956150,10956159,10956154,9
14988,3484102,4,85566,86622,86094,1056
14989,3484102,4,5455490,5456227,5455858,737
14990,3484102,4,15815387,15815755,15815571,368
14991,3484102,5,15034119,15034684,15034401,565
14992,3484102,5,25108622,25108836,25108729,214
