,Num,Chr,Start,Stop,Crossover_sites,Size
0,1,1,10516519,10516888,10516703,369
1,1,2,5013425,5013493,5013459,68
2,1,2,13002744,13002795,13002769,51
3,1,3,3129592,3129923,3129757,331
4,1,3,10514396,10514592,10514494,196
5,1,3,17025973,17027890,17026931,1917
6,1,5,2038036,2038042,2038039,6
7,1,5,19829341,19829813,19829577,472
8,2,1,13051029,13054815,13052922,3786
9,2,1,28419374,28420130,28419752,756
10,2,2,6894363,6895632,6894997,1269
11,2,3,22814354,22815016,22814685,662
12,2,4,5562661,5562910,5562785,249
13,2,4,7331974,7332926,7332450,952
14,2,5,15010528,15010868,15010698,340
15,2,5,23859124,23861463,23860293,2339
16,3,1,23312918,23313408,23313163,490
17,3,2,6519400,6520223,6519811,823
18,3,3,649238,650576,649907,1338
19,3,3,8216171,8216848,8216509,677
20,3,3,20022379,20022463,20022421,84
21,3,3,20840926,20842478,20841702,1552
22,3,3,22671897,22673645,22672771,1748
23,3,4,1521164,1521938,1521551,774
24,3,4,9837259,9837383,9837321,124
25,3,5,1186639,1186815,1186727,176
26,3,5,26401076,26403499,26402287,2423
27,4,1,8942488,8943003,8942745,515
28,4,1,22924011,22924144,22924077,133
29,4,1,30390833,30391070,30390951,237
30,4,2,9360430,9360933,9360681,503
31,4,3,15661550,15662182,15661866,632
32,4,3,20031159,20031193,20031176,34
33,4,5,10486369,10486602,10486485,233
34,4,5,23367861,23367889,23367875,28
35,5,1,17253039,17253798,17253418,759
36,5,1,29636818,29637186,29637002,368
37,5,2,6223408,6223966,6223687,558
38,5,2,18263198,18263306,18263252,108
39,5,3,18807903,18808184,18808043,281
40,5,5,23921315,23922271,23921793,956
41,6,1,20456719,20457724,20457221,1005
42,6,2,13031326,13031459,13031392,133
43,6,2,15347036,15348060,15347548,1024
44,6,2,18174768,18192909,18183838,18141
45,6,3,8145696,8145887,8145791,191
46,6,4,215483,215705,215594,222
47,6,5,725031,725057,725044,26
48,6,5,18809253,18810157,18809705,904
49,7,1,4774972,4775303,4775137,331
50,7,1,8376520,8377019,8376769,499
51,7,1,17664789,17664795,17664792,6
52,7,1,29648660,29650298,29649479,1638
53,7,2,10846192,10846208,10846200,16
54,7,2,15030360,15031274,15030817,914
55,7,2,16151630,16152116,16151873,486
56,7,3,6332188,6332402,6332295,214
57,7,3,9213039,9213128,9213083,89
58,7,5,14077980,14078048,14078014,68
59,7,5,25716719,25716838,25716778,119
60,8,1,16548402,16549028,16548715,626
61,8,2,6310921,6316198,6313559,5277
62,8,3,8547314,8547378,8547346,64
63,8,4,8854418,8854807,8854612,389
64,8,4,13859640,13860252,13859946,612
65,9,1,7370243,7370436,7370339,193
66,9,2,6093628,6093816,6093722,188
67,9,3,4083131,4083136,4083133,5
68,9,3,10941722,10942527,10942124,805
69,9,3,21036185,21036255,21036220,70
70,9,4,8754812,8754906,8754859,94
71,9,5,4050938,4055649,4053293,4711
72,10,1,7384993,7385082,7385037,89
73,10,1,19286207,19286355,19286281,148
74,10,1,29696847,29697353,29697100,506
75,10,2,6904102,6904759,6904430,657
76,10,3,3365455,3371744,3368599,6289
77,10,3,7787412,7788107,7787759,695
78,10,3,18006550,18006825,18006687,275
79,10,4,399849,400577,400213,728
80,10,4,14201362,14202503,14201932,1141
81,10,5,25302702,25302837,25302769,135
82,11,1,4034108,4034601,4034354,493
83,11,1,10693928,10694804,10694366,876
84,11,1,20470718,20472814,20471766,2096
85,11,1,26219848,26219938,26219893,90
86,11,1,29809387,29809460,29809423,73
87,11,2,7697777,7700070,7698923,2293
88,11,2,12919307,12919523,12919415,216
89,11,2,12963179,12965938,12964558,2759
90,11,3,457233,457940,457586,707
91,11,3,17012113,17012868,17012490,755
92,11,4,5736520,5737091,5736805,571
93,11,4,7373633,7375379,7374506,1746
94,11,4,11898058,11898757,11898407,699
95,11,5,697677,698056,697866,379
96,11,5,8848670,8849169,8848919,499
97,11,5,16855769,16858727,16857248,2958
98,11,5,25694848,25695680,25695264,832
99,12,1,4590452,4590806,4590629,354
100,12,1,19468313,19468710,19468511,397
101,12,1,28958346,28959654,28959000,1308
102,12,2,19003638,19005611,19004624,1973
103,12,3,3436300,3437945,3437122,1645
104,12,3,10126503,10126944,10126723,441
105,12,3,18559277,18559454,18559365,177
106,12,4,5150583,5151873,5151228,1290
107,12,4,9325335,9325452,9325393,117
108,12,5,101466,101739,101602,273
109,12,5,13771616,13771680,13771648,64
110,13,1,12227673,12228425,12228049,752
111,13,1,30054647,30054967,30054807,320
112,13,2,15888130,15889583,15888856,1453
113,13,3,15785102,15786035,15785568,933
114,13,4,5735405,5736038,5735721,633
115,13,4,7641428,7641521,7641474,93
116,13,5,9553742,9553848,9553795,106
117,13,5,26230406,26230955,26230680,549
118,14,1,7752277,7753446,7752861,1169
119,14,2,10555050,10556549,10555799,1499
120,14,2,11903891,11907623,11905757,3732
121,14,3,10614999,10615303,10615151,304
122,14,3,17588292,17591745,17590018,3453
123,14,3,17997566,17998989,17998277,1423
124,14,4,8548368,8549030,8548699,662
125,14,4,11912375,11912716,11912545,341
126,14,5,5256625,5256897,5256761,272
127,14,5,26713043,26713121,26713082,78
128,15,1,19957896,19958551,19958223,655
129,15,2,410258,410430,410344,172
130,15,2,853365,853977,853671,612
131,15,2,13704291,13704639,13704465,348
132,15,4,9558733,9558746,9558739,13
133,15,5,390794,391357,391075,563
134,15,5,798799,798937,798868,138
135,15,5,25038893,25039409,25039151,516
136,16,1,29524528,29524598,29524563,70
137,16,2,16629140,16630145,16629642,1005
138,16,3,17973116,17976391,17974753,3275
139,16,3,20589064,20589281,20589172,217
140,16,4,7549398,7549759,7549578,361
141,16,4,10147985,10148090,10148037,105
142,16,5,8214507,8214813,8214660,306
143,16,5,24644987,24645308,24645147,321
144,17,1,20598749,20598858,20598803,109
145,17,3,7700528,7700933,7700730,405
146,17,3,18301454,18302582,18302018,1128
147,17,4,10812400,10812484,10812442,84
148,17,5,17509054,17509361,17509207,307
149,18,1,1121219,1121361,1121290,142
150,18,1,9802374,9805692,9804033,3318
151,18,1,19366150,19366265,19366207,115
152,18,2,12955878,12956333,12956105,455
153,18,3,132545,133532,133038,987
154,18,3,8952677,8952773,8952725,96
155,18,4,60550,60920,60735,370
156,18,4,18024190,18025475,18024832,1285
157,18,5,1017635,1017822,1017728,187
158,18,5,5635913,5637602,5636757,1689
159,18,5,20433685,20433732,20433708,47
160,18,5,20711138,20711881,20711509,743
161,19,1,4246369,4246522,4246445,153
162,19,1,21893108,21893141,21893124,33
163,19,2,7422091,7422288,7422189,197
164,19,2,18819301,18819645,18819473,344
165,19,3,3730322,3731809,3731065,1487
166,19,3,10544809,10576807,10560808,31998
167,19,3,15880765,15880835,15880800,70
168,19,5,743305,743341,743323,36
169,19,5,16209192,16209693,16209442,501
170,19,5,19422867,19423059,19422963,192
171,20,1,1187418,1187419,1187418,1
172,20,1,7202448,7202645,7202546,197
173,20,1,7802090,7802204,7802147,114
174,20,1,22882652,22882661,22882656,9
175,20,1,24394523,24395205,24394864,682
176,20,2,5538735,5538848,5538791,113
177,20,2,13386787,13387557,13387172,770
178,20,3,12448410,12448965,12448687,555
179,20,4,7326500,7328347,7327423,1847
180,20,4,14639295,14641382,14640338,2087
181,20,5,9845365,9845561,9845463,196
182,20,5,17651894,17652020,17651957,126
183,20,5,23934732,23934817,23934774,85
184,21,1,464929,465818,465373,889
185,21,1,13081660,13081974,13081817,314
186,21,1,22693711,22693801,22693756,90
187,21,1,23459582,23459647,23459614,65
188,21,2,2243882,2243944,2243913,62
189,21,2,10117833,10117872,10117852,39
190,21,2,18174768,18192909,18183838,18141
191,21,3,21715632,21715788,21715710,156
192,21,4,314389,314443,314416,54
193,21,4,8219082,8219462,8219272,380
194,21,4,16898327,16898739,16898533,412
195,21,4,17392147,17392530,17392338,383
196,21,5,10932042,10932296,10932169,254
197,21,5,17580957,17580963,17580960,6
198,22,1,6714197,6714295,6714246,98
199,22,1,19871338,19873401,19872369,2063
200,22,1,20605860,20606644,20606252,784
201,22,2,621943,623192,622567,1249
202,22,3,10175827,10176474,10176150,647
203,22,4,12986896,12986932,12986914,36
204,22,4,14652516,14653488,14653002,972
205,22,5,9300534,9300940,9300737,406
206,22,5,13551443,13552766,13552104,1323
207,23,1,10596524,10596859,10596691,335
208,23,1,26334476,26335313,26334894,837
209,23,1,28454347,28455290,28454818,943
210,23,2,17667049,17667173,17667111,124
211,23,2,19467502,19467607,19467554,105
212,23,3,8029389,8031488,8030438,2099
213,23,5,8705184,8705821,8705502,637
214,24,1,11092356,11093302,11092829,946
215,24,1,24443906,24446927,24445416,3021
216,24,2,9149353,9149629,9149491,276
217,24,3,19214119,19216013,19215066,1894
218,25,1,5127313,5127398,5127355,85
219,25,1,7536418,7536469,7536443,51
220,25,1,13986613,13987609,13987111,996
221,25,2,495253,495450,495351,197
222,25,3,7282681,7284148,7283414,1467
223,25,3,9052902,9053546,9053224,644
224,25,4,9188254,9188366,9188310,112
225,25,5,9302719,9302735,9302727,16
226,26,1,10607728,10607830,10607779,102
227,26,1,20092730,20092912,20092821,182
228,26,2,7708045,7709243,7708644,1198
229,26,4,301329,301956,301642,627
230,26,4,6016113,6016583,6016348,470
231,26,4,11721945,11722135,11722040,190
232,26,5,8981882,8983494,8982688,1612
233,27,1,616982,617800,617391,818
234,27,1,9993622,9993724,9993673,102
235,27,1,24056335,24056634,24056484,299
236,27,1,24744579,24745640,24745109,1061
237,27,2,2183518,2183792,2183655,274
238,27,2,12913484,12914209,12913846,725
239,27,2,18704114,18704676,18704395,562
240,27,3,10390585,10390681,10390633,96
241,27,3,18823793,18824142,18823967,349
242,27,4,11419190,11419605,11419397,415
243,27,5,572616,573007,572811,391
244,27,5,10612658,10612756,10612707,98
245,27,5,18733554,18733921,18733737,367
246,28,1,8120783,8122336,8121559,1553
247,28,1,19242565,19243059,19242812,494
248,28,1,26392648,26392945,26392796,297
249,28,2,145186,145187,145186,1
250,28,2,13950401,13950699,13950550,298
251,28,3,9130733,9130851,9130792,118
252,28,3,17567403,17567881,17567642,478
253,28,4,17984927,17985556,17985241,629
254,28,5,15305234,15305464,15305349,230
255,29,1,2356394,2357413,2356903,1019
256,29,1,9330869,9333449,9332159,2580
257,29,1,19048879,19048921,19048900,42
258,29,1,25324205,25324254,25324229,49
259,29,3,8296396,8296594,8296495,198
260,29,3,20062038,20064156,20063097,2118
261,29,4,923301,924715,924008,1414
262,29,4,14405892,14406598,14406245,706
263,29,5,2483635,2483981,2483808,346
264,29,5,4984366,4984425,4984395,59
265,29,5,16307644,16308284,16307964,640
266,30,1,4571496,4571546,4571521,50
267,30,1,16232096,16232596,16232346,500
268,30,1,25973512,25973975,25973743,463
269,30,3,269559,269759,269659,200
270,30,4,10837604,10837831,10837717,227
271,30,4,13372144,13373065,13372604,921
272,30,5,6337115,6337945,6337530,830
273,30,5,15709083,15709431,15709257,348
274,31,1,5130937,5130946,5130941,9
275,31,1,8307354,8308186,8307770,832
276,31,1,18690898,18690963,18690930,65
277,31,1,26726312,26726664,26726488,352
278,31,2,624109,624249,624179,140
279,31,2,15226397,15226954,15226675,557
280,31,3,5418902,5418914,5418908,12
281,31,3,21681549,21683115,21682332,1566
282,31,4,8459429,8459637,8459533,208
283,31,5,2308864,2309211,2309037,347
284,31,5,18246899,18247089,18246994,190
285,31,5,25862890,25864757,25863823,1867
286,32,1,10208094,10208168,10208131,74
287,32,1,18329109,18330052,18329580,943
288,32,1,24869502,24869670,24869586,168
289,32,2,305967,306298,306132,331
290,32,2,1572627,1573619,1573123,992
291,32,4,12450369,12450579,12450474,210
292,32,5,824718,824905,824811,187
293,32,5,22179713,22179885,22179799,172
294,33,1,2679553,2684066,2681809,4513
295,33,4,250251,250313,250282,62
296,33,5,2358077,2358943,2358510,866
297,33,5,3591469,3592197,3591833,728
298,33,5,19748737,19748863,19748800,126
299,34,1,9825780,9828244,9827012,2464
300,34,2,10266920,10267330,10267125,410
301,34,2,12225387,12226000,12225693,613
302,34,3,11915332,11915941,11915636,609
303,34,4,412810,412959,412884,149
304,34,5,17928637,17930023,17929330,1386
305,34,5,20632143,20632818,20632480,675
306,35,1,7432839,7433227,7433033,388
307,35,1,17287683,17288068,17287875,385
308,35,1,21420555,21420661,21420608,106
309,35,2,606247,607682,606964,1435
310,35,2,669114,669335,669224,221
311,35,3,7344875,7344915,7344895,40
312,35,4,512297,512558,512427,261
313,35,4,5373673,5373979,5373826,306
314,35,4,15197253,15197876,15197564,623
315,35,4,16715183,16715614,16715398,431
316,35,5,8037436,8037505,8037470,69
317,36,1,23808544,23809719,23809131,1175
318,36,2,7251606,7251858,7251732,252
319,36,2,12338860,12339408,12339134,548
320,36,3,3050613,3051117,3050865,504
321,36,3,16651059,16651081,16651070,22
322,36,4,9010656,9010729,9010692,73
323,36,4,17498690,17499224,17498957,534
324,36,5,800479,800617,800548,138
325,36,5,5757816,5759016,5758416,1200
326,36,5,20011118,20011332,20011225,214
327,36,5,22084018,22086306,22085162,2288
328,37,1,7991430,7993233,7992331,1803
329,37,1,24864701,24865246,24864973,545
330,37,3,20950411,20950776,20950593,365
331,37,4,12695867,12696335,12696101,468
332,38,1,6879348,6879810,6879579,462
333,38,1,19589441,19589462,19589451,21
334,38,2,12970363,12970616,12970489,253
335,38,3,22983033,22983454,22983243,421
336,38,4,8917217,8919130,8918173,1913
337,38,4,14468809,14469120,14468964,311
338,38,5,4638161,4639050,4638605,889
339,38,5,6838455,6838640,6838547,185
340,38,5,19542097,19542281,19542189,184
341,38,5,23933415,23933650,23933532,235
342,39,1,20245070,20251024,20248047,5954
343,39,2,10164071,10164470,10164270,399
344,39,4,12257517,12258966,12258241,1449
345,39,5,14531573,14531669,14531621,96
346,39,5,16924883,16925627,16925255,744
347,39,5,24490844,24491191,24491017,347
348,40,1,4133018,4133345,4133181,327
349,40,1,28863622,28865576,28864599,1954
350,40,1,29363132,29364553,29363842,1421
351,40,2,15563987,15568822,15566404,4835
352,40,4,6328464,6329850,6329157,1386
353,40,5,15789768,15790023,15789895,255
354,40,5,26289259,26289368,26289313,109
355,41,1,1105667,1108301,1106984,2634
356,41,1,6875102,6875633,6875367,531
357,41,1,26143168,26143440,26143304,272
358,41,1,29711365,29711628,29711496,263
359,41,2,7516095,7516745,7516420,650
360,41,2,13891187,13891624,13891405,437
361,41,4,5603171,5603257,5603214,86
362,41,4,15137482,15139288,15138385,1806
363,41,5,16929,18412,17670,1483
364,41,5,23290986,23292232,23291609,1246
365,42,1,27321333,27321563,27321448,230
366,42,2,12152497,12154421,12153459,1924
367,42,2,14686801,14687220,14687010,419
368,42,3,9666154,9666248,9666201,94
369,42,4,6632381,6632511,6632446,130
370,42,4,14148714,14148814,14148764,100
371,42,5,386586,387471,387028,885
372,42,5,6368036,6368951,6368493,915
373,43,1,6332643,6334302,6333472,1659
374,43,1,16562601,16562728,16562664,127
375,43,1,24231446,24231452,24231449,6
376,43,2,10271495,10271710,10271602,215
377,43,2,16220764,16221350,16221057,586
378,43,3,9762636,9763467,9763051,831
379,43,3,18999958,19000519,19000238,561
380,43,5,7347258,7347396,7347327,138
381,44,1,12607954,12608114,12608034,160
382,44,2,6014152,6015129,6014640,977
383,44,2,18343953,18344001,18343977,48
384,44,3,8491493,8493638,8492565,2145
385,44,3,9591609,9591753,9591681,144
386,44,3,21741793,21745308,21743550,3515
387,44,4,6880843,6881084,6880963,241
388,44,5,2488296,2489598,2488947,1302
389,44,5,21765750,21779715,21772732,13965
390,44,5,25066686,25066954,25066820,268
391,45,1,16130498,16131373,16130935,875
392,45,3,3588536,3589200,3588868,664
393,45,3,18052253,18052639,18052446,386
394,45,4,4844769,4845249,4845009,480
395,45,4,9758429,9758719,9758574,290
396,45,5,26138206,26138341,26138273,135
397,46,1,19641348,19641591,19641469,243
398,46,2,7851176,7851343,7851259,167
399,46,2,12960655,12960660,12960657,5
400,46,3,16421239,16421314,16421276,75
401,46,3,21834726,21836072,21835399,1346
402,46,4,7959464,7959962,7959713,498
403,46,4,11750773,11751163,11750968,390
404,46,5,18777102,18777276,18777189,174
405,47,1,19512351,19512861,19512606,510
406,47,1,23538774,23538974,23538874,200
407,47,1,27299970,27300082,27300026,112
408,47,2,15566431,15568822,15567626,2391
409,47,3,8608412,8610873,8609642,2461
410,47,3,9401862,9402021,9401941,159
411,47,4,10501716,10501836,10501776,120
412,47,5,1095420,1095922,1095671,502
413,47,5,7047273,7047328,7047300,55
414,47,5,18912858,18913783,18913320,925
415,47,5,21641986,21643524,21642755,1538
416,48,1,7782954,7784386,7783670,1432
417,48,2,6547214,6547245,6547229,31
418,48,3,1578503,1579293,1578898,790
419,48,4,11743135,11743289,11743212,154
420,48,5,19606965,19607529,19607247,564
421,49,1,21577787,21580518,21579152,2731
422,49,1,22831621,22831927,22831774,306
423,49,2,11537539,11537596,11537567,57
424,49,3,5334576,5334588,5334582,12
425,49,5,1795368,1795437,1795402,69
426,49,5,2613933,2614526,2614229,593
427,49,5,20541514,20542808,20542161,1294
428,49,5,23335247,23335710,23335478,463
429,50,1,1175600,1175773,1175686,173
430,50,1,6923964,6924272,6924118,308
431,50,1,28034833,28034887,28034860,54
432,50,2,7025502,7029744,7027623,4242
433,50,2,10832782,10832850,10832816,68
434,50,2,18855483,18857542,18856512,2059
435,50,3,3775521,3775613,3775567,92
436,50,3,16565777,16565827,16565802,50
437,50,3,18673005,18674157,18673581,1152
438,50,5,3343273,3343307,3343290,34
439,51,1,4165058,4165272,4165165,214
440,51,1,6247465,6248012,6247738,547
441,51,2,454760,456346,455553,1586
442,51,3,3351064,3351468,3351266,404
443,51,3,20733742,20734088,20733915,346
444,51,5,2971903,2972605,2972254,702
445,52,1,18026403,18026856,18026629,453
446,52,3,8142619,8142627,8142623,8
447,52,4,7274904,7275460,7275182,556
448,52,4,12113158,12113433,12113295,275
449,52,5,4811110,4813099,4812104,1989
450,52,5,16212255,16212528,16212391,273
451,52,5,17781443,17781629,17781536,186
452,52,5,25986553,25987279,25986916,726
453,52,5,26959242,26959744,26959493,502
454,53,1,7337035,7337122,7337078,87
455,53,1,8137899,8138288,8138093,389
456,53,1,29372559,29373518,29373038,959
457,53,2,6210886,6211598,6211242,712
458,53,2,15552184,15562451,15557317,10267
459,53,5,5935233,5935283,5935258,50
460,53,5,15703110,15703346,15703228,236
461,54,1,10923908,10924213,10924060,305
462,54,2,8049553,8049909,8049731,356
463,54,4,280202,280777,280489,575
464,54,4,7623145,7623188,7623166,43
465,54,4,10867842,10867969,10867905,127
466,54,4,14268930,14269507,14269218,577
467,54,4,14813952,14813984,14813968,32
468,54,5,1640770,1641105,1640937,335
469,54,5,16093864,16093894,16093879,30
470,54,5,16646317,16646365,16646341,48
471,55,1,3875085,3877554,3876319,2469
472,55,2,10012157,10012284,10012220,127
473,55,3,11369692,11369829,11369760,137
474,55,4,10934006,10934295,10934150,289
475,55,5,1010048,1010342,1010195,294
476,55,5,25834939,25835643,25835291,704
477,56,1,22343023,22343200,22343111,177
478,56,4,182555,184086,183320,1531
479,56,4,8459637,8460205,8459921,568
480,56,4,17661830,17662119,17661974,289
481,56,5,714119,716202,715160,2083
482,56,5,26218972,26219262,26219117,290
483,57,1,12003902,12003943,12003922,41
484,57,1,29635673,29635765,29635719,92
485,57,2,9322555,9322638,9322596,83
486,57,3,8984110,8984146,8984128,36
487,57,5,10899834,10899965,10899899,131
488,58,1,6588288,6588403,6588345,115
489,58,1,23348071,23348074,23348072,3
490,58,1,24833470,24833503,24833486,33
491,58,1,25297110,25297121,25297115,11
492,58,1,26451223,26451867,26451545,644
493,58,2,8556918,8557284,8557101,366
494,58,2,9964363,9964761,9964562,398
495,58,3,1255261,1256118,1255689,857
496,58,3,9711722,9711952,9711837,230
497,58,3,22090940,22091049,22090994,109
498,58,5,5256038,5256121,5256079,83
499,58,5,14123337,14126345,14124841,3008
500,58,5,24191350,24191366,24191358,16
501,59,1,10606014,10607728,10606871,1714
502,59,1,12228425,12233379,12230902,4954
503,59,2,356361,356583,356472,222
504,59,2,11981247,11984492,11982869,3245
505,59,4,976581,983150,979865,6569
506,59,4,6646402,6646647,6646524,245
507,59,4,16310825,16315175,16313000,4350
508,59,5,793,1155,974,362
509,59,5,629738,630005,629871,267
510,59,5,6456827,6456872,6456849,45
511,60,2,806708,806790,806749,82
512,60,2,836067,838140,837103,2073
513,60,2,15759188,15764167,15761677,4979
514,60,3,3060331,3061251,3060791,920
515,60,3,17684207,17684375,17684291,168
516,60,4,10356398,10357263,10356830,865
517,60,5,9850802,9851526,9851164,724
518,60,5,18095253,18098476,18096864,3223
519,60,5,24964708,24965239,24964973,531
520,61,1,9390999,9391392,9391195,393
521,61,1,24579328,24579329,24579328,1
522,61,2,15274831,15276064,15275447,1233
523,61,2,15282113,15284101,15283107,1988
524,61,3,4218817,4219356,4219086,539
525,61,3,9054363,9054752,9054557,389
526,61,3,22738592,22740079,22739335,1487
527,61,4,11567209,11569548,11568378,2339
528,61,4,16177807,16179972,16178889,2165
529,61,5,2038367,2038554,2038460,187
530,61,5,4262620,4263224,4262922,604
531,61,5,5249888,5251618,5250753,1730
532,61,5,18486372,18486420,18486396,48
533,61,5,20518902,20518951,20518926,49
534,62,1,7038294,7040667,7039480,2373
535,62,1,17366979,17367033,17367006,54
536,62,1,23887674,23887682,23887678,8
537,62,2,6813260,6813319,6813289,59
538,62,3,1855491,1855832,1855661,341
539,62,3,9259830,9260555,9260192,725
540,62,4,1192386,1192533,1192459,147
541,62,4,6267386,6267524,6267455,138
542,62,4,10572459,10573671,10573065,1212
543,62,4,17683249,17683475,17683362,226
544,62,5,9119611,9119647,9119629,36
545,62,5,15920573,15920593,15920583,20
546,62,5,21660480,21660624,21660552,144
547,63,1,13079700,13079789,13079744,89
548,63,1,26305628,26305805,26305716,177
549,63,2,6860611,6860646,6860628,35
550,63,3,17425168,17425553,17425360,385
551,63,3,23356507,23356832,23356669,325
552,63,4,465410,465959,465684,549
553,63,5,5591487,5593484,5592485,1997
554,63,5,8385391,8385534,8385462,143
555,63,5,21571544,21571767,21571655,223
556,64,1,9213916,9225971,9219943,12055
557,64,1,23147228,23147309,23147268,81
558,64,2,1696501,1696878,1696689,377
559,64,2,2331063,2331193,2331128,130
560,64,3,2478216,2478338,2478277,122
561,64,4,775982,776513,776247,531
562,64,4,18191278,18191701,18191489,423
563,64,5,5654739,5655240,5654989,501
564,64,5,15449140,15449273,15449206,133
565,65,1,25313526,25313550,25313538,24
566,65,2,151274,151344,151309,70
567,65,2,6813096,6813187,6813141,91
568,65,2,7408068,7408119,7408093,51
569,65,3,9426929,9429075,9428002,2146
570,65,3,17464098,17464847,17464472,749
571,65,4,8011799,8012814,8012306,1015
572,65,4,16317167,16318223,16317695,1056
573,65,5,8993932,8994177,8994054,245
574,65,5,9905997,9907042,9906519,1045
575,66,1,23259593,23259960,23259776,367
576,66,1,24770871,24770935,24770903,64
577,66,1,28707111,28739401,28723256,32290
578,66,2,12206402,12211864,12209133,5462
579,66,5,1036220,1037220,1036720,1000
580,67,1,17167700,17167881,17167790,181
581,67,1,21191884,21192296,21192090,412
582,67,3,18929259,18929293,18929276,34
583,67,4,6418351,6419952,6419151,1601
584,67,4,11755132,11755161,11755146,29
585,67,5,20905950,20906245,20906097,295
586,67,5,26731341,26732432,26731886,1091
587,68,2,273567,273586,273576,19
588,68,3,4462001,4462154,4462077,153
589,68,3,7614086,7615338,7614712,1252
590,68,3,16970369,16971098,16970733,729
591,68,4,5161680,5162587,5162133,907
592,68,5,16590055,16590219,16590137,164
593,68,5,25717116,25717742,25717429,626
594,69,1,1288787,1382716,1335751,93929
595,69,1,10371003,10372328,10371665,1325
596,69,1,13986427,13986613,13986520,186
597,69,1,29328843,29328999,29328921,156
598,69,2,378454,378561,378507,107
599,69,3,10684398,10684619,10684508,221
600,69,3,19823813,19824473,19824143,660
601,69,4,7233074,7233127,7233100,53
602,69,4,8731735,8731764,8731749,29
603,69,5,3256475,3256962,3256718,487
604,69,5,8620150,8621226,8620688,1076
605,69,5,24524904,24525973,24525438,1069
606,70,1,11471217,11471403,11471310,186
607,70,2,229477,229899,229688,422
608,70,2,10264525,10264837,10264681,312
609,70,2,16029291,16029356,16029323,65
610,70,3,10059998,10060052,10060025,54
611,70,3,16459233,16459959,16459596,726
612,70,4,5353011,5353127,5353069,116
613,70,5,9655246,9656102,9655674,856
614,70,5,16009555,16009567,16009561,12
615,70,5,26532282,26533478,26532880,1196
616,71,1,21947588,21951424,21949506,3836
617,71,1,24657177,24658388,24657782,1211
618,71,2,6016848,6016878,6016863,30
619,71,2,12374475,12374651,12374563,176
620,71,3,10617860,10618021,10617940,161
621,71,5,6419841,6421308,6420574,1467
622,72,1,1688098,1689718,1688908,1620
623,72,2,400539,400873,400706,334
624,72,3,728908,729693,729300,785
625,72,3,10091336,10094760,10093048,3424
626,72,3,22204274,22204307,22204290,33
627,72,4,11004782,11007788,11006285,3006
628,72,5,622966,623749,623357,783
629,72,5,20677852,20677873,20677862,21
630,73,1,6795151,6795847,6795499,696
631,73,1,7808727,7809058,7808892,331
632,73,1,17373048,17375615,17374331,2567
633,73,1,21117069,21117636,21117352,567
634,73,1,28419354,28419374,28419364,20
635,73,2,827326,827459,827392,133
636,73,3,23157077,23157177,23157127,100
637,73,4,5716167,5717280,5716723,1113
638,73,4,13129368,13132665,13131016,3297
639,73,4,17338101,17338403,17338252,302
640,73,5,8839121,8839564,8839342,443
641,74,1,3047428,3047732,3047580,304
642,74,1,17281721,17281839,17281780,118
643,74,1,29316779,29318199,29317489,1420
644,74,2,157393,161539,159466,4146
645,74,2,13910296,13912977,13911636,2681
646,74,3,10357616,10358232,10357924,616
647,74,4,12102109,12102274,12102191,165
648,74,4,16587784,16588980,16588382,1196
649,74,5,6409787,6410558,6410172,771
650,74,5,25982134,25982357,25982245,223
651,75,1,10350712,10354013,10352362,3301
652,75,1,12871137,12872094,12871615,957
653,75,1,22969690,22969901,22969795,211
654,75,1,29442809,29443292,29443050,483
655,75,2,1928525,1928545,1928535,20
656,75,3,9000166,9000666,9000416,500
657,75,4,16750555,16750812,16750683,257
658,75,5,26527821,26528712,26528266,891
659,76,1,16135258,16135421,16135339,163
660,76,2,5507750,5508268,5508009,518
661,76,3,2408128,2408593,2408360,465
662,76,3,11284270,11284306,11284288,36
663,76,4,11483793,11484018,11483905,225
664,76,5,23899283,23899290,23899286,7
665,77,1,24609669,24611127,24610398,1458
666,77,1,26978500,26978536,26978518,36
667,77,2,11682296,11683361,11682828,1065
668,77,3,19420881,19420992,19420936,111
669,77,4,14129096,14129731,14129413,635
670,77,5,1175022,1175191,1175106,169
671,77,5,15248130,15248817,15248473,687
672,78,1,2820443,2820576,2820509,133
673,78,1,17232062,17232764,17232413,702
674,78,1,26125257,26126078,26125667,821
675,78,1,28884867,28890014,28887440,5147
676,78,2,19014885,19014963,19014924,78
677,78,4,10808207,10808817,10808512,610
678,78,4,13673196,13673351,13673273,155
679,78,4,17385004,17385323,17385163,319
680,78,5,131484,131655,131569,171
681,78,5,25015526,25016529,25016027,1003
682,78,5,26742135,26742454,26742294,319
683,79,1,7398953,7399005,7398979,52
684,79,1,10140419,10140433,10140426,14
685,79,1,21393804,21393890,21393847,86
686,79,1,27088460,27090082,27089271,1622
687,79,3,8723860,8725868,8724864,2008
688,79,3,23186531,23187205,23186868,674
689,79,4,5461574,5461595,5461584,21
690,79,4,13675184,13676843,13676013,1659
691,80,1,1174243,1175561,1174902,1318
692,80,1,9226859,9227501,9227180,642
693,80,1,21341238,21341300,21341269,62
694,80,2,9738825,9740314,9739569,1489
695,80,3,4083614,4083766,4083690,152
696,80,3,20876498,20878203,20877350,1705
697,80,4,10492370,10492428,10492399,58
698,81,1,12064317,12064468,12064392,151
699,81,1,26179812,26180527,26180169,715
700,81,2,240646,242178,241412,1532
701,81,3,8224154,8224979,8224566,825
702,81,4,2877127,2877216,2877171,89
703,81,4,4641718,4641798,4641758,80
704,81,5,5637602,5638074,5637838,472
705,81,5,6137112,6137362,6137237,250
706,81,5,15639558,15639605,15639581,47
707,81,5,20098452,20098521,20098486,69
708,82,1,18604495,18604763,18604629,268
709,82,1,27337233,27338144,27337688,911
710,82,2,2349277,2349405,2349341,128
711,82,2,9621238,9623171,9622204,1933
712,82,4,14272622,14273798,14273210,1176
713,82,5,18784988,18785123,18785055,135
714,83,1,1064221,1065037,1064629,816
715,83,1,16578185,16578275,16578230,90
716,83,1,16835617,16836276,16835946,659
717,83,2,12783204,12783385,12783294,181
718,83,3,10355494,10355610,10355552,116
719,83,3,10414767,10415922,10415344,1155
720,83,5,5402636,5402781,5402708,145
721,83,5,6143650,6143931,6143790,281
722,84,1,29744212,29744494,29744353,282
723,84,3,412682,413410,413046,728
724,84,4,9852000,9852291,9852145,291
725,84,4,11967891,11968427,11968159,536
726,84,5,20771335,20772218,20771776,883
727,85,1,20873257,20873493,20873375,236
728,85,2,8580568,8581423,8580995,855
729,85,3,11400368,11401105,11400736,737
730,85,3,17697962,17698351,17698156,389
731,85,4,12536508,12537210,12536859,702
732,85,5,9959934,9960208,9960071,274
733,85,5,18636216,18636287,18636251,71
734,85,5,24471321,24476964,24474142,5643
735,86,1,13276190,13276532,13276361,342
736,86,1,21364986,21366774,21365880,1788
737,86,3,7880356,7880386,7880371,30
738,86,3,9462983,9464360,9463671,1377
739,86,5,6629168,6635915,6632541,6747
740,86,5,10029461,10029494,10029477,33
741,87,1,9800230,9800297,9800263,67
742,87,1,12646196,12646488,12646342,292
743,87,1,24221151,24223737,24222444,2586
744,87,2,9807048,9809616,9808332,2568
745,87,3,16301339,16301459,16301399,120
746,87,4,377381,377528,377454,147
747,87,4,10710660,10712472,10711566,1812
748,87,4,11316879,11317166,11317022,287
749,87,5,7351011,7351121,7351066,110
750,87,5,13771680,13772457,13772068,777
751,88,1,2190593,2190974,2190783,381
752,88,1,21267534,21268055,21267794,521
753,88,1,23745013,23746431,23745722,1418
754,88,2,6022849,6022964,6022906,115
755,88,2,10616143,10616170,10616156,27
756,88,4,6221827,6221932,6221879,105
757,88,5,8777233,8777258,8777245,25
758,88,5,9875328,9877437,9876382,2109
759,89,1,4766768,4768637,4767702,1869
760,89,1,24428187,24428401,24428294,214
761,89,2,8254632,8255648,8255140,1016
762,89,3,10888962,10889948,10889455,986
763,89,4,6016702,6017063,6016882,361
764,89,4,13832324,13837846,13835085,5522
765,89,5,2291729,2292315,2292022,586
766,89,5,7884455,7885046,7884750,591
767,89,5,9685244,9685584,9685414,340
768,90,2,7032166,7033373,7032769,1207
769,90,2,15122019,15124965,15123492,2946
770,90,3,2502882,2504981,2503931,2099
771,90,3,9018528,9018677,9018602,149
772,90,3,22160874,22162596,22161735,1722
773,90,5,21901828,21902323,21902075,495
774,91,1,7527533,7527831,7527682,298
775,91,2,6516950,6517359,6517154,409
776,91,2,16555019,16555309,16555164,290
777,91,3,10358883,10358955,10358919,72
778,91,4,12364553,12366019,12365286,1466
779,91,5,16313785,16314983,16314384,1198
780,91,5,16925627,16926372,16925999,745
781,92,1,8936911,8937208,8937059,297
782,92,1,20042210,20042294,20042252,84
783,92,1,28855290,28855811,28855550,521
784,92,3,18902759,18904687,18903723,1928
785,92,4,746584,746592,746588,8
786,92,4,11180642,11181595,11181118,953
787,92,5,172050,172212,172131,162
788,92,5,9310156,9310427,9310291,271
789,92,5,18590901,18591253,18591077,352
790,93,1,7472336,7472394,7472365,58
791,93,1,25766822,25767130,25766976,308
792,93,2,5007754,5009234,5008494,1480
793,93,2,17946222,17947699,17946960,1477
794,93,3,1735881,1736694,1736287,813
795,93,5,532938,532978,532958,40
796,93,5,14314539,14315002,14314770,463
797,94,1,22896023,22896445,22896234,422
798,94,1,26393942,26394395,26394168,453
799,94,3,18599868,18608299,18604083,8431
800,94,4,16760726,16761029,16760877,303
801,94,5,701463,701608,701535,145
802,94,5,14715978,14716778,14716378,800
803,95,1,2988522,2988629,2988575,107
804,95,1,28504480,28504651,28504565,171
805,95,2,6507273,6507325,6507299,52
806,95,3,3188146,3189637,3188891,1491
807,95,3,10802988,10803527,10803257,539
808,95,3,23187205,23189021,23188113,1816
809,95,4,744173,745995,745084,1822
810,95,4,5802284,5802615,5802449,331
811,95,5,13481814,13482706,13482260,892
812,95,5,21362352,21362491,21362421,139
813,96,1,17864902,17865087,17864994,185
814,96,2,6801071,6802479,6801775,1408
815,96,2,10061238,10061256,10061247,18
816,96,4,5182645,5182918,5182781,273
817,96,4,17699580,17699900,17699740,320
818,96,5,536670,536876,536773,206
819,96,5,7485413,7486697,7486055,1284
820,97,1,21100295,21100464,21100379,169
821,97,2,6395362,6398202,6396782,2840
822,97,2,17463526,17464034,17463780,508
823,97,3,4375927,4377450,4376688,1523
824,97,3,16460868,16461872,16461370,1004
825,97,4,5458722,5458850,5458786,128
826,97,4,17011275,17014641,17012958,3366
827,98,1,21510623,21510689,21510656,66
828,98,3,17758155,17761570,17759862,3415
829,98,3,19502805,19503230,19503017,425
830,98,4,11432202,11434043,11433122,1841
831,98,5,915253,915473,915363,220
832,99,1,4213984,4214251,4214117,267
833,99,1,21468864,21469048,21468956,184
834,99,2,1917351,1917353,1917352,2
835,99,2,9580578,9582009,9581293,1431
836,99,3,7600526,7600731,7600628,205
837,99,3,17505975,17507186,17506580,1211
838,99,4,5404616,5404932,5404774,316
839,99,4,12462733,12464325,12463529,1592
840,99,4,17467465,17467919,17467692,454
841,99,5,4183996,4184107,4184051,111
842,100,1,1132213,1133099,1132656,886
843,100,1,8976678,8977128,8976903,450
844,100,2,6211598,6212355,6211976,757
845,100,3,513127,513273,513200,146
846,100,3,17162926,17163148,17163037,222
847,100,3,18175903,18176533,18176218,630
848,100,4,9754530,9754803,9754666,273
849,100,4,18451246,18452493,18451869,1247
850,100,5,3542111,3543188,3542649,1077
851,100,5,17778150,17778496,17778323,346
852,101,1,20208404,20208467,20208435,63
853,101,1,26310471,26310500,26310485,29
854,101,2,1407734,1407906,1407820,172
855,101,2,19261047,19261210,19261128,163
856,101,3,11909244,11910594,11909919,1350
857,101,4,10659034,10659445,10659239,411
858,101,5,7271105,7271121,7271113,16
859,102,1,27308851,27308973,27308912,122
860,102,2,7383314,7384536,7383925,1222
861,102,2,13308083,13309943,13309013,1860
862,102,2,19259712,19261047,19260379,1335
863,102,3,1540080,1540191,1540135,111
864,102,3,9720976,9721214,9721095,238
865,102,4,5451108,5451111,5451109,3
866,102,4,17145654,17146372,17146013,718
867,102,5,2676530,2676749,2676639,219
868,103,1,21440066,21441105,21440585,1039
869,103,1,26392648,26392945,26392796,297
870,103,2,293506,295106,294306,1600
871,103,2,7859431,7859484,7859457,53
872,103,2,17726622,17727252,17726937,630
873,103,3,1855832,1857574,1856703,1742
874,103,3,4753034,4754218,4753626,1184
875,103,4,737506,738187,737846,681
876,103,5,1177307,1177708,1177507,401
877,103,5,24116220,24116297,24116258,77
878,104,1,10454017,10455115,10454566,1098
879,104,1,18328784,18329053,18328918,269
880,104,1,27601757,27601841,27601799,84
881,104,2,7365632,7365944,7365788,312
882,104,4,14568070,14568109,14568089,39
883,105,1,6482488,6483090,6482789,602
884,105,1,17594051,17594674,17594362,623
885,105,2,11550191,11550831,11550511,640
886,105,4,5351199,5351474,5351336,275
887,105,4,8319668,8320510,8320089,842
888,105,5,26044736,26044846,26044791,110
889,106,1,10049812,10053223,10051517,3411
890,106,1,28513271,28513775,28513523,504
891,106,2,10405384,10406214,10405799,830
892,106,3,19942532,19942987,19942759,455
893,106,3,22376196,22377257,22376726,1061
894,106,4,18170091,18170418,18170254,327
895,106,5,10149204,10149458,10149331,254
896,106,5,15202507,15210766,15206636,8259
897,106,5,24338135,24338746,24338440,611
898,106,5,26265247,26265292,26265269,45
899,107,1,26542887,26543742,26543314,855
900,107,2,6974852,6974915,6974883,63
901,107,2,7636620,7636947,7636783,327
902,107,2,16273376,16273446,16273411,70
903,107,3,3776348,3776885,3776616,537
904,107,3,9191561,9193105,9192333,1544
905,107,4,84364,84619,84491,255
906,107,4,17134293,17134914,17134603,621
907,107,5,23044799,23044965,23044882,166
908,108,1,25671022,25671156,25671089,134
909,108,2,7603301,7603914,7603607,613
910,108,3,610831,611022,610926,191
911,108,3,16549709,16549777,16549743,68
912,108,3,19722446,19722886,19722666,440
913,108,4,5737587,5738869,5738228,1282
914,108,5,5650616,5650855,5650735,239
915,108,5,9268294,9268333,9268313,39
916,109,1,6393905,6394402,6394153,497
917,109,1,22519746,22520552,22520149,806
918,109,2,5389546,5389778,5389662,232
919,109,2,11669003,11671747,11670375,2744
920,109,3,22636336,22636413,22636374,77
921,109,3,23355061,23356193,23355627,1132
922,109,4,9142182,9142312,9142247,130
923,109,4,11912086,11912247,11912166,161
924,109,4,16365380,16365561,16365470,181
925,109,5,16869233,16870318,16869775,1085
926,109,5,18219603,18219678,18219640,75
927,109,5,26806836,26806880,26806858,44
928,110,1,8719695,8722312,8721003,2617
929,110,1,26042209,26042510,26042359,301
930,110,2,1609614,1609658,1609636,44
931,110,2,16058435,16058825,16058630,390
932,110,3,8929731,8930592,8930161,861
933,110,3,11141102,11141320,11141211,218
934,110,5,9991311,9991547,9991429,236
935,110,5,22878294,22880182,22879238,1888
936,111,2,10463649,10463851,10463750,202
937,111,2,12619701,12619780,12619740,79
938,111,2,16655210,16656453,16655831,1243
939,111,3,5780243,5780430,5780336,187
940,111,3,15744256,15744299,15744277,43
941,111,4,182185,182555,182370,370
942,111,4,10832819,10833024,10832921,205
943,111,4,11772639,11773266,11772952,627
944,111,5,9220868,9221685,9221276,817
945,112,1,4116573,4116614,4116593,41
946,112,1,10879754,10880428,10880091,674
947,112,1,16413812,16413918,16413865,106
948,112,2,1855153,1856119,1855636,966
949,112,3,17544532,17544937,17544734,405
950,112,3,18232620,18232694,18232657,74
951,112,4,10049509,10049964,10049736,455
952,112,4,17805995,17806863,17806429,868
953,112,5,18669740,18669908,18669824,168
954,113,1,170728,171250,170989,522
955,113,1,8146475,8146731,8146603,256
956,113,1,17488254,17488358,17488306,104
957,113,2,14494292,14494912,14494602,620
958,113,4,10724124,10727941,10726032,3817
959,113,5,23841646,23841747,23841696,101
960,114,2,16466516,16466575,16466545,59
961,114,3,5469112,5469687,5469399,575
962,114,3,18900040,18900236,18900138,196
963,114,3,19312285,19323523,19317904,11238
964,114,4,281118,281478,281298,360
965,114,4,17558925,17559000,17558962,75
966,114,5,10651300,10651927,10651613,627
967,115,1,3529412,3530081,3529746,669
968,115,1,4230063,4231000,4230531,937
969,115,1,19548742,19549105,19548923,363
970,115,1,24843815,24844122,24843968,307
971,115,2,6835803,6835850,6835826,47
972,115,2,10224348,10224549,10224448,201
973,115,3,8720238,8722381,8721309,2143
974,115,3,20929706,20929729,20929717,23
975,115,4,8319214,8319578,8319396,364
976,115,5,8682511,8684049,8683280,1538
977,115,5,21033570,21033898,21033734,328
978,116,1,2222062,2222092,2222077,30
979,116,1,16775858,16777060,16776459,1202
980,116,2,7220709,7220739,7220724,30
981,116,2,18626181,18627510,18626845,1329
982,116,4,648780,650792,649786,2012
983,116,4,9943973,9944028,9944000,55
984,116,5,690297,691179,690738,882
985,116,5,4307486,4307569,4307527,83
986,116,5,25787074,25787247,25787160,173
987,117,1,16488491,16488858,16488674,367
988,117,2,12148929,12149065,12148997,136
989,117,2,17203878,17203929,17203903,51
990,117,3,11211029,11211350,11211189,321
991,117,5,33082,37184,35133,4102
992,117,5,9077649,9077815,9077732,166
993,117,5,20070860,20070863,20070861,3
994,118,1,8275981,8276153,8276067,172
995,118,1,16133722,16134080,16133901,358
996,118,2,111954,113118,112536,1164
997,118,2,6498106,6498126,6498116,20
998,118,2,12196418,12196723,12196570,305
999,118,3,21139608,21140596,21140102,988
1000,118,4,5424692,5425362,5425027,670
1001,118,4,6338832,6338871,6338851,39
1002,118,4,16692495,16692715,16692605,220
1003,118,5,6689805,6690405,6690105,600
1004,119,1,7337851,7338232,7338041,381
1005,119,2,12002449,12002771,12002610,322
1006,119,2,15585063,15585315,15585189,252
1007,119,3,16080683,16080885,16080784,202
1008,119,5,18792566,18797626,18795096,5060
1009,120,1,9015851,9016004,9015927,153
1010,120,1,24395902,24395963,24395932,61
1011,120,1,25396213,25396451,25396332,238
1012,120,1,29395199,29396596,29395897,1397
1013,120,2,813735,814382,814058,647
1014,120,2,9590293,9591615,9590954,1322
1015,120,3,1476890,1477141,1477015,251
1016,120,4,1330863,1330875,1330869,12
1017,120,5,5580161,5587539,5583850,7378
1018,121,1,9261289,9304817,9283053,43528
1019,121,2,8541954,8544356,8543155,2402
1020,121,2,11929973,11930055,11930014,82
1021,121,3,8109055,8109340,8109197,285
1022,121,5,1453255,1453741,1453498,486
1023,121,5,23855206,23857046,23856126,1840
1024,122,1,8137292,8137878,8137585,586
1025,122,1,19860956,19861034,19860995,78
1026,122,2,18076966,18078318,18077642,1352
1027,122,3,9436635,9454688,9445661,18053
1028,122,3,15197018,15197251,15197134,233
1029,122,4,7377845,7378861,7378353,1016
1030,122,5,14299758,14299885,14299821,127
1031,122,5,24078424,24079262,24078843,838
1032,123,1,159434,159941,159687,507
1033,123,1,11824869,11825333,11825101,464
1034,123,1,25881522,25881537,25881529,15
1035,123,2,16152116,16152294,16152205,178
1036,123,3,8891754,8891832,8891793,78
1037,123,3,12651319,12651900,12651609,581
1038,123,5,23418488,23421000,23419744,2512
1039,124,1,26245620,26245791,26245705,171
1040,124,1,26555868,26555989,26555928,121
1041,124,2,1021988,1022100,1022044,112
1042,124,3,745848,745866,745857,18
1043,124,4,11914055,11914086,11914070,31
1044,124,4,14429081,14429716,14429398,635
1045,124,5,10171205,10171269,10171237,64
1046,124,5,13464264,13466628,13465446,2364
1047,124,5,26360669,26360789,26360729,120
1048,125,1,1659344,1660379,1659861,1035
1049,125,1,9365937,9366823,9366380,886
1050,125,1,24610384,24611127,24610755,743
1051,125,1,26155641,26155964,26155802,323
1052,125,3,8610873,8611042,8610957,169
1053,125,3,18940460,18941430,18940945,970
1054,125,4,7454592,7454708,7454650,116
1055,125,5,7226239,7226506,7226372,267
1056,125,5,15714132,15714221,15714176,89
1057,125,5,25792116,25792752,25792434,636
1058,126,1,9956636,9956981,9956808,345
1059,126,1,11545846,11546035,11545940,189
1060,126,2,9226298,9226962,9226630,664
1061,126,3,5368669,5371646,5370157,2977
1062,126,3,22297619,22298599,22298109,980
1063,126,4,156944,157203,157073,259
1064,126,4,8608007,8608179,8608093,172
1065,126,4,11763712,11764074,11763893,362
1066,126,5,7861657,7862772,7862214,1115
1067,127,1,986719,1022802,1004760,36083
1068,127,1,8404954,8405037,8404995,83
1069,127,1,11552883,11553153,11553018,270
1070,127,1,21444658,21445968,21445313,1310
1071,127,2,9556669,9556961,9556815,292
1072,127,2,12966207,12966452,12966329,245
1073,127,3,16617729,16618206,16617967,477
1074,127,3,23168883,23170244,23169563,1361
1075,127,5,787594,787720,787657,126
1076,127,5,20675219,20675394,20675306,175
1077,128,1,4044777,4045437,4045107,660
1078,128,1,18119763,18120192,18119977,429
1079,128,2,6746159,6756444,6751301,10285
1080,128,2,16909705,16909770,16909737,65
1081,128,3,8923137,8924193,8923665,1056
1082,128,3,11147585,11147758,11147671,173
1083,128,4,1257011,1257337,1257174,326
1084,128,4,11729755,11730565,11730160,810
1085,128,5,8547181,8547330,8547255,149
1086,129,1,20017522,20017577,20017549,55
1087,129,1,24634999,24635911,24635455,912
1088,129,2,6289804,6290020,6289912,216
1089,129,3,538142,538182,538162,40
1090,129,3,18300409,18300617,18300513,208
1091,129,3,20549039,20549771,20549405,732
1092,129,4,5317130,5317190,5317160,60
1093,129,5,97084,97132,97108,48
1094,129,5,8387234,8387848,8387541,614
1095,130,1,16808147,16808326,16808236,179
1096,130,1,18767136,18770843,18768989,3707
1097,130,2,1493779,1493851,1493815,72
1098,130,2,10354654,10354889,10354771,235
1099,130,2,18714373,18716511,18715442,2138
1100,130,3,16431598,16434127,16432862,2529
1101,130,4,8088851,8088905,8088878,54
1102,130,4,9102331,9103244,9102787,913
1103,131,1,7899341,7900588,7899964,1247
1104,131,2,10513177,10513202,10513189,25
1105,131,3,2941888,2942221,2942054,333
1106,131,4,16946077,16946434,16946255,357
1107,131,5,15426805,15427123,15426964,318
1108,132,1,2676533,2677744,2677138,1211
1109,132,1,11111663,11112720,11112191,1057
1110,132,2,505877,505879,505878,2
1111,132,2,14337019,14338409,14337714,1390
1112,132,3,9633355,9633398,9633376,43
1113,132,3,9986294,9986649,9986471,355
1114,132,4,9414554,9414630,9414592,76
1115,132,5,2777650,2777934,2777792,284
1116,132,5,24155585,24155916,24155750,331
1117,133,1,12971762,12973147,12972454,1385
1118,133,1,18885707,18886561,18886134,854
1119,133,2,905317,905369,905343,52
1120,133,3,6146510,6147133,6146821,623
1121,133,4,402209,402766,402487,557
1122,133,5,20107260,20157935,20132597,50675
1123,134,1,4943495,4943754,4943624,259
1124,134,1,23106146,23106199,23106172,53
1125,134,1,23701420,23701572,23701496,152
1126,134,2,8379240,8379346,8379293,106
1127,134,2,17984949,17986491,17985720,1542
1128,134,3,1101406,1101661,1101533,255
1129,134,3,18371957,18372076,18372016,119
1130,134,3,18531677,18531741,18531709,64
1131,134,4,17330152,17330958,17330555,806
1132,134,5,1220178,1220245,1220211,67
1133,134,5,18461563,18462144,18461853,581
1134,135,1,644148,644770,644459,622
1135,135,1,9823068,9823215,9823141,147
1136,135,1,17617218,17617553,17617385,335
1137,135,1,28930155,28930280,28930217,125
1138,135,3,9540252,9541424,9540838,1172
1139,135,3,18493865,18494445,18494155,580
1140,135,4,4809251,4809370,4809310,119
1141,135,4,10945552,10945889,10945720,337
1142,135,4,13119427,13120061,13119744,634
1143,135,4,16878040,16882099,16880069,4059
1144,135,5,17779324,17779821,17779572,497
1145,135,5,18582830,18584164,18583497,1334
1146,135,5,26871263,26871569,26871416,306
1147,136,1,19546546,19547255,19546900,709
1148,136,1,29098463,29102446,29100454,3983
1149,136,2,1541214,1541339,1541276,125
1150,136,2,14283686,14283759,14283722,73
1151,136,3,8878524,8879157,8878840,633
1152,136,3,22788227,22789228,22788727,1001
1153,136,4,436639,437986,437312,1347
1154,136,4,17234033,17235650,17234841,1617
1155,136,5,10261698,10262010,10261854,312
1156,137,1,301465,301587,301526,122
1157,137,1,9786288,9787283,9786785,995
1158,137,1,13258928,13259280,13259104,352
1159,137,1,23028208,23029242,23028725,1034
1160,137,2,7362208,7363672,7362940,1464
1161,137,3,10456270,10456659,10456464,389
1162,137,4,17518042,17519073,17518557,1031
1163,138,1,4578584,4578957,4578770,373
1164,138,1,7202400,7202448,7202424,48
1165,138,1,23211692,23213179,23212435,1487
1166,138,3,15221849,15221882,15221865,33
1167,138,3,21900438,21900610,21900524,172
1168,138,4,8114705,8114806,8114755,101
1169,138,5,6780549,6781347,6780948,798
1170,138,5,17611290,17611926,17611608,636
1171,138,5,22178685,22178791,22178738,106
1172,139,1,24097924,24098023,24097973,99
1173,139,1,25881538,25882070,25881804,532
1174,139,3,321598,322771,322184,1173
1175,139,4,10239316,10239738,10239527,422
1176,139,5,2383167,2383959,2383563,792
1177,139,5,22086306,22086365,22086335,59
1178,140,1,16897300,16897570,16897435,270
1179,140,2,17168060,17170480,17169270,2420
1180,140,3,11052643,11053418,11053030,775
1181,140,3,21437821,21437888,21437854,67
1182,140,4,5371924,5372087,5372005,163
1183,140,4,12001750,12002698,12002224,948
1184,140,5,22454776,22454816,22454796,40
1185,141,1,314437,371972,343204,57535
1186,141,1,7280966,7281104,7281035,138
1187,141,1,10145799,10146559,10146179,760
1188,141,1,26746063,26746175,26746119,112
1189,141,1,28564936,28565915,28565425,979
1190,141,2,6197302,6197361,6197331,59
1191,141,2,9237928,9238645,9238286,717
1192,141,3,9769469,9769482,9769475,13
1193,141,4,5150583,5151873,5151228,1290
1194,141,4,7440565,7440684,7440624,119
1195,141,4,18177419,18178552,18177985,1133
1196,141,5,121436,124185,122810,2749
1197,142,1,3347984,3354275,3351129,6291
1198,142,1,21979329,21979544,21979436,215
1199,142,2,8419968,8423541,8421754,3573
1200,142,2,8559272,8560389,8559830,1117
1201,142,2,15031269,15031274,15031271,5
1202,142,4,7486939,7487526,7487232,587
1203,142,4,14911401,14913053,14912227,1652
1204,143,1,10523647,10530334,10526990,6687
1205,143,1,17282324,17282513,17282418,189
1206,143,1,21729078,21729134,21729106,56
1207,143,2,13410599,13410785,13410692,186
1208,143,3,9939511,9940341,9939926,830
1209,143,3,17369570,17369824,17369697,254
1210,143,4,8391468,8391544,8391506,76
1211,143,5,15134815,15134892,15134853,77
1212,143,5,26210948,26211653,26211300,705
1213,144,1,9179774,9180073,9179923,299
1214,144,1,10056800,10057433,10057116,633
1215,144,1,17856421,17856553,17856487,132
1216,144,1,26163312,26163897,26163604,585
1217,144,3,1419318,1420018,1419668,700
1218,144,3,5644502,5645534,5645018,1032
1219,144,3,18507886,18507979,18507932,93
1220,144,4,5738869,5738899,5738884,30
1221,144,4,12856247,12856283,12856265,36
1222,144,5,13870297,13870806,13870551,509
1223,145,1,10705916,10706843,10706379,927
1224,145,1,23989668,23990560,23990114,892
1225,145,2,8906050,8907254,8906652,1204
1226,145,3,8192646,8192887,8192766,241
1227,145,3,10853421,10853475,10853448,54
1228,145,5,7038845,7038847,7038846,2
1229,145,5,14561628,14561676,14561652,48
1230,146,1,4590452,4590806,4590629,354
1231,146,2,11827429,11828084,11827756,655
1232,146,3,4402636,4403260,4402948,624
1233,146,3,8684319,8684413,8684366,94
1234,146,3,10617699,10617860,10617779,161
1235,146,4,9936943,9937035,9936989,92
1236,146,4,14784485,14786673,14785579,2188
1237,146,5,15977286,15979307,15978296,2021
1238,147,1,11139781,11141205,11140493,1424
1239,147,1,18120699,18120825,18120762,126
1240,147,3,9761448,9761587,9761517,139
1241,147,3,16557693,16557785,16557739,92
1242,147,4,17682885,17682918,17682901,33
1243,147,5,23669024,23669432,23669228,408
1244,148,2,1652596,1652893,1652744,297
1245,148,2,13307968,13308083,13308025,115
1246,148,2,18058147,18058479,18058313,332
1247,148,3,15990069,15990167,15990118,98
1248,148,3,18838778,18839133,18838955,355
1249,148,4,301329,301956,301642,627
1250,148,4,11662279,11662426,11662352,147
1251,149,1,9457911,9458197,9458054,286
1252,149,1,11685278,11685306,11685292,28
1253,149,1,22930281,22930472,22930376,191
1254,149,2,11881531,11883518,11882524,1987
1255,149,2,16813581,16813957,16813769,376
1256,149,3,20110859,20111122,20110990,263
1257,149,4,11995818,11996227,11996022,409
1258,149,4,18450864,18450884,18450874,20
1259,149,5,3207736,3208120,3207928,384
1260,149,5,19066361,19066788,19066574,427
1261,149,5,25444016,25444755,25444385,739
1262,150,1,25317013,25317223,25317118,210
1263,150,3,2165792,2166529,2166160,737
1264,150,3,19807418,19807583,19807500,165
1265,150,4,6748170,6748651,6748410,481
1266,150,5,3443980,3445014,3444497,1034
1267,151,1,7041339,7045933,7043636,4594
1268,151,1,7756594,7757278,7756936,684
1269,151,1,19691145,19695673,19693409,4528
1270,151,3,16399658,16399666,16399662,8
1271,151,4,6221086,6221131,6221108,45
1272,151,5,575271,575349,575310,78
1273,151,5,15487889,15488255,15488072,366
1274,152,1,17768126,17768443,17768284,317
1275,152,1,23514372,23514560,23514466,188
1276,152,2,9976039,9977524,9976781,1485
1277,152,2,10831126,10831579,10831352,453
1278,152,2,12423071,12424612,12423841,1541
1279,152,3,17601882,17601898,17601890,16
1280,152,3,18666308,18668323,18667315,2015
1281,152,4,7999218,7999275,7999246,57
1282,152,5,6447198,6451340,6449269,4142
1283,153,1,7901196,7901643,7901419,447
1284,153,1,17219781,17220202,17219991,421
1285,153,2,13298420,13298662,13298541,242
1286,153,3,9302750,9302825,9302787,75
1287,153,3,10365153,10366180,10365666,1027
1288,153,3,21877777,21879409,21878593,1632
1289,153,4,1248265,1248356,1248310,91
1290,153,4,16839612,16839633,16839622,21
1291,153,5,20013733,20018032,20015882,4299
1292,154,1,22625308,22626004,22625656,696
1293,154,2,13888028,13888060,13888044,32
1294,154,4,11268796,11268884,11268840,88
1295,155,1,11223127,11223660,11223393,533
1296,155,1,17425596,17427047,17426321,1451
1297,155,1,22517415,22518075,22517745,660
1298,155,3,15934856,15935140,15934998,284
1299,155,4,9970468,9970900,9970684,432
1300,155,4,10267156,10267199,10267177,43
1301,155,5,15777605,15777646,15777625,41
1302,155,5,18954506,18954575,18954540,69
1303,156,1,1148269,1148420,1148344,151
1304,156,1,17292875,17293150,17293012,275
1305,156,2,11839929,11843360,11841644,3431
1306,156,2,17071110,17071554,17071332,444
1307,156,3,7864457,7866053,7865255,1596
1308,156,3,15214364,15214374,15214369,10
1309,156,4,6146661,6146859,6146760,198
1310,156,5,472540,472835,472687,295
1311,156,5,14747516,14747720,14747618,204
1312,156,5,26107463,26107693,26107578,230
1313,157,1,658928,660534,659731,1606
1314,157,1,10677037,10677698,10677367,661
1315,157,1,22170154,22170721,22170437,567
1316,157,2,594079,594654,594366,575
1317,157,2,16061459,16061502,16061480,43
1318,157,4,8393263,8393306,8393284,43
1319,157,4,11796800,11797357,11797078,557
1320,157,5,8323474,8323856,8323665,382
1321,158,1,2871042,2871155,2871098,113
1322,158,1,19641808,19642543,19642175,735
1323,158,1,21312033,21312472,21312252,439
1324,158,2,8718939,8719198,8719068,259
1325,158,4,5567344,5567525,5567434,181
1326,158,4,6249729,6252344,6251036,2615
1327,158,5,1564452,1564479,1564465,27
1328,158,5,23349852,23351410,23350631,1558
1329,159,1,8036376,8037613,8036994,1237
1330,159,1,27776319,27776744,27776531,425
1331,159,2,444150,445071,444610,921
1332,159,2,10591311,10591509,10591410,198
1333,159,2,14599237,14599947,14599592,710
1334,159,4,6235705,6236156,6235930,451
1335,159,4,7835679,7835943,7835811,264
1336,159,4,8277191,8277326,8277258,135
1337,159,4,11151924,11152043,11151983,119
1338,159,4,11602559,11602567,11602563,8
1339,159,4,12070079,12072303,12071191,2224
1340,159,4,18168124,18168685,18168404,561
1341,159,5,9024517,9034693,9029605,10176
1342,159,5,17722883,17723173,17723028,290
1343,159,5,18769833,18769851,18769842,18
1344,159,5,25043959,25046068,25045013,2109
1345,160,1,4154843,4155026,4154934,183
1346,160,1,8505058,8505105,8505081,47
1347,160,1,21717590,21718694,21718142,1104
1348,160,2,14493213,14494098,14493655,885
1349,160,3,6381244,6384407,6382825,3163
1350,160,3,9126994,9127092,9127043,98
1351,160,3,9711722,9711952,9711837,230
1352,160,3,19701950,19702282,19702116,332
1353,160,3,22103487,22105612,22104549,2125
1354,160,4,1191469,1192086,1191777,617
1355,160,4,1635953,1637143,1636548,1190
1356,160,4,15159732,15168364,15164048,8632
1357,160,4,16288413,16288852,16288632,439
1358,160,5,2480105,2481048,2480576,943
1359,160,5,13662618,13662859,13662738,241
1360,160,5,23884782,23884854,23884818,72
1361,160,5,25269248,25271047,25270147,1799
1362,160,5,25940326,25940779,25940552,453
1363,160,5,26714678,26720488,26717583,5810
1364,161,1,3180543,3180634,3180588,91
1365,161,1,7892243,7898065,7895154,5822
1366,161,1,17622471,17622969,17622720,498
1367,161,2,9660553,9660634,9660593,81
1368,161,2,15890511,15890621,15890566,110
1369,161,3,8002643,8002697,8002670,54
1370,161,3,17570983,17571082,17571032,99
1371,161,3,18730692,18731174,18730933,482
1372,161,4,1188955,1190399,1189677,1444
1373,161,4,7259384,7260080,7259732,696
1374,161,5,21045752,21046023,21045887,271
1375,162,1,6889502,6891565,6890533,2063
1376,162,1,8363141,8372017,8367579,8876
1377,162,1,21172260,21172435,21172347,175
1378,162,1,28455409,28456198,28455803,789
1379,162,2,6242269,6242419,6242344,150
1380,162,2,9229293,9230022,9229657,729
1381,162,3,6319199,6319481,6319340,282
1382,162,5,25955613,25956134,25955873,521
1383,163,1,4592281,4593343,4592812,1062
1384,163,1,13227215,13228385,13227800,1170
1385,163,1,13876449,13876476,13876462,27
1386,163,1,16124982,16125154,16125068,172
1387,163,1,17997307,17997924,17997615,617
1388,163,1,18528679,18529917,18529298,1238
1389,163,1,19098318,19098427,19098372,109
1390,163,1,25249379,25249429,25249404,50
1391,163,1,27714289,27714543,27714416,254
1392,163,2,11718379,11718418,11718398,39
1393,163,3,4561111,4561267,4561189,156
1394,163,3,11113061,11114163,11113612,1102
1395,163,3,19574483,19574671,19574577,188
1396,163,3,20167469,20167565,20167517,96
1397,163,3,23283571,23283586,23283578,15
1398,163,4,5436843,5437081,5436962,238
1399,163,5,4458389,4460319,4459354,1930
1400,163,5,25787247,25787448,25787347,201
1401,164,1,2657897,2658286,2658091,389
1402,164,1,6376812,6377225,6377018,413
1403,164,1,6787712,6787749,6787730,37
1404,164,1,10984451,10984782,10984616,331
1405,164,1,11937287,11937526,11937406,239
1406,164,1,26864109,26864147,26864128,38
1407,164,1,27656256,27656670,27656463,414
1408,164,2,849720,849988,849854,268
1409,164,2,15677614,15677996,15677805,382
1410,164,3,1080313,1080323,1080318,10
1411,164,3,4553612,4553645,4553628,33
1412,164,3,6380452,6380557,6380504,105
1413,164,3,8799504,8799524,8799514,20
1414,164,3,10140321,10140373,10140347,52
1415,164,3,11034081,11034208,11034144,127
1416,164,3,12076138,12076171,12076154,33
1417,164,3,16525894,16527212,16526553,1318
1418,164,3,21261922,21262072,21261997,150
1419,164,4,8188014,8188311,8188162,297
1420,164,5,398758,399011,398884,253
1421,164,5,2046347,2046486,2046416,139
1422,164,5,2720866,2733775,2727320,12909
1423,164,5,18904267,18904444,18904355,177
1424,164,5,19707054,19707477,19707265,423
1425,164,5,20380753,20381583,20381168,830
1426,164,5,22426986,22429566,22428276,2580
1427,165,1,1689718,1689833,1689775,115
1428,165,1,2646345,2649626,2647985,3281
1429,165,1,7334395,7335788,7335091,1393
1430,165,1,9393232,9399324,9396278,6092
1431,165,3,10525267,10525311,10525289,44
1432,165,3,16497793,16497827,16497810,34
1433,165,3,17089620,17091573,17090596,1953
1434,165,4,10689367,10691954,10690660,2587
1435,165,4,11439870,11441782,11440826,1912
1436,165,5,14635324,14636823,14636073,1499
1437,166,1,28218197,28218397,28218297,200
1438,166,2,9940292,9940742,9940517,450
1439,166,3,5026122,5026143,5026132,21
1440,167,1,1222326,1223092,1222709,766
1441,167,1,2490657,2490771,2490714,114
1442,167,1,3220680,3221028,3220854,348
1443,167,1,4169521,4170633,4170077,1112
1444,167,1,5137692,5137708,5137700,16
1445,167,1,6909432,6909939,6909685,507
1446,167,1,11451616,11451890,11451753,274
1447,167,2,338345,338707,338526,362
1448,167,2,6440193,6440388,6440290,195
1449,167,2,8215897,8222689,8219293,6792
1450,167,2,8646869,8647783,8647326,914
1451,167,2,12235084,12236438,12235761,1354
1452,167,2,14424202,14425451,14424826,1249
1453,167,2,15332114,15332230,15332172,116
1454,167,2,18683076,18684103,18683589,1027
1455,167,3,3620618,3620633,3620625,15
1456,167,3,6651772,6659021,6655396,7249
1457,167,3,7676311,7678678,7677494,2367
1458,167,3,8225097,8226098,8225597,1001
1459,167,3,14946053,14946127,14946090,74
1460,167,3,17978454,17978498,17978476,44
1461,167,3,20042214,20042375,20042294,161
1462,167,4,11559595,11560554,11560074,959
1463,167,4,14526863,14526943,14526903,80
1464,167,4,16657109,16659523,16658316,2414
1465,167,4,17682244,17682885,17682564,641
1466,167,4,18309402,18309757,18309579,355
1467,167,5,8001279,8001398,8001338,119
1468,167,5,9588103,9596833,9592468,8730
1469,167,5,24074930,24075661,24075295,731
1470,167,5,25842383,25843472,25842927,1089
1471,168,2,10068542,10068577,10068559,35
1472,168,3,7529883,7530465,7530174,582
1473,168,4,15063454,15064280,15063867,826
1474,168,5,10723672,10723903,10723787,231
1475,168,5,17245865,17246025,17245945,160
1476,168,5,17850469,17852988,17851728,2519
1477,168,5,20429140,20429223,20429181,83
1478,168,5,20870268,20874872,20872570,4604
1479,169,1,8473927,8474049,8473988,122
1480,169,1,10502206,10502323,10502264,117
1481,169,1,26633988,26634570,26634279,582
1482,169,2,1710670,1710686,1710678,16
1483,169,3,8077198,8077787,8077492,589
1484,169,3,20550742,20551139,20550940,397
1485,169,5,37185,37352,37268,167
1486,170,1,12653657,12653793,12653725,136
1487,170,2,365116,368010,366563,2894
1488,170,2,15379832,15380613,15380222,781
1489,170,3,5695135,5695162,5695148,27
1490,170,5,1150843,1151537,1151190,694
1491,170,5,19580297,19581039,19580668,742
1492,171,1,9117947,9119152,9118549,1205
1493,171,1,23609559,23610062,23609810,503
1494,171,1,27840202,27840415,27840308,213
1495,171,2,18831625,18831733,18831679,108
1496,171,3,9831669,9832264,9831966,595
1497,171,3,16189275,16189343,16189309,68
1498,171,4,654371,655269,654820,898
1499,171,4,16091797,16093204,16092500,1407
1500,171,4,16599167,16599301,16599234,134
1501,171,5,4620510,4620552,4620531,42
1502,171,5,8810782,8810900,8810841,118
1503,171,5,22281753,22281778,22281765,25
1504,172,1,4614876,4615407,4615141,531
1505,172,1,19418813,19418890,19418851,77
1506,172,3,22320469,22320737,22320603,268
1507,172,4,6386412,6386595,6386503,183
1508,172,4,18466872,18467261,18467066,389
1509,172,5,597157,597368,597262,211
1510,172,5,2060114,2060238,2060176,124
1511,172,5,7874361,7874527,7874444,166
1512,173,1,2135267,2135633,2135450,366
1513,173,3,4735825,4735922,4735873,97
1514,173,3,10358453,10358741,10358597,288
1515,173,3,20557633,20557747,20557690,114
1516,173,4,9964884,9965385,9965134,501
1517,173,4,10779541,10780375,10779958,834
1518,173,5,14564388,14565084,14564736,696
1519,174,1,2480439,2485851,2483145,5412
1520,174,1,6681966,6682144,6682055,178
1521,174,1,23320292,23320393,23320342,101
1522,174,2,2096583,2096599,2096591,16
1523,174,2,13326528,13327208,13326868,680
1524,174,3,6351081,6351098,6351089,17
1525,174,3,11285987,11286180,11286083,193
1526,174,4,185967,186173,186070,206
1527,174,4,7828715,7829164,7828939,449
1528,174,4,14511196,14511565,14511380,369
1529,175,1,25445561,25445643,25445602,82
1530,175,2,7578303,7578322,7578312,19
1531,175,3,7137402,7137938,7137670,536
1532,175,3,21435092,21437806,21436449,2714
1533,175,4,15957651,15957691,15957671,40
1534,176,2,7563384,7563669,7563526,285
1535,176,2,9966033,9966527,9966280,494
1536,176,3,1767218,1769104,1768161,1886
1537,176,3,17385384,17385501,17385442,117
1538,176,3,19735499,19735617,19735558,118
1539,176,4,790184,791303,790743,1119
1540,176,4,832872,833138,833005,266
1541,176,4,11544276,11544351,11544313,75
1542,176,4,12497970,12498715,12498342,745
1543,176,4,13658716,13659773,13659244,1057
1544,176,5,7069105,7070614,7069859,1509
1545,176,5,16088664,16090527,16089595,1863
1546,176,5,19749821,19749836,19749828,15
1547,176,5,24016820,24018038,24017429,1218
1548,177,1,1201049,1201325,1201187,276
1549,177,1,25567483,25568031,25567757,548
1550,177,2,10010701,10010750,10010725,49
1551,177,2,11489014,11491663,11490338,2649
1552,177,2,17646954,17647565,17647259,611
1553,177,2,18425491,18425903,18425697,412
1554,177,3,521089,521323,521206,234
1555,177,4,215017,215363,215190,346
1556,177,4,10298936,10298993,10298964,57
1557,177,4,11441782,11442663,11442222,881
1558,177,5,263785,264290,264037,505
1559,177,5,1147849,1147928,1147888,79
1560,177,5,16236316,16238047,16237181,1731
1561,178,3,10044779,10046302,10045540,1523
1562,178,4,276143,276205,276174,62
1563,178,5,15996398,15996936,15996667,538
1564,178,5,26105620,26106777,26106198,1157
1565,179,1,12200896,12201670,12201283,774
1566,179,1,13331886,13331920,13331903,34
1567,179,1,22722036,22722305,22722170,269
1568,179,1,29758908,29758990,29758949,82
1569,179,1,30262102,30262417,30262259,315
1570,179,2,991056,991364,991210,308
1571,179,2,5031276,5031365,5031320,89
1572,179,2,6227769,6227887,6227828,118
1573,179,2,6899350,6899439,6899394,89
1574,179,2,10851305,10851854,10851579,549
1575,179,2,19217919,19219987,19218953,2068
1576,179,3,462985,464063,463524,1078
1577,179,3,895206,896673,895939,1467
1578,179,3,1489077,1489246,1489161,169
1579,179,3,10608235,10608489,10608362,254
1580,179,3,21059262,21059424,21059343,162
1581,179,3,23224974,23225026,23225000,52
1582,179,4,4198988,4199249,4199118,261
1583,179,4,11939391,11939412,11939401,21
1584,179,5,3253244,3253885,3253564,641
1585,179,5,18559848,18559872,18559860,24
1586,179,5,18987949,18987968,18987958,19
1587,179,5,19462601,19464468,19463534,1867
1588,180,1,1219320,1219574,1219447,254
1589,180,1,5139750,5143863,5141806,4113
1590,180,1,16484096,16484232,16484164,136
1591,180,2,6001046,6001470,6001258,424
1592,180,2,13837764,13837903,13837833,139
1593,180,3,2890750,2891367,2891058,617
1594,180,3,14751059,14751319,14751189,260
1595,180,3,22835558,22848199,22841878,12641
1596,180,4,12101651,12102109,12101880,458
1597,180,5,8960978,8981546,8971262,20568
1598,180,5,15778657,15778821,15778739,164
1599,181,1,4773285,4773428,4773356,143
1600,181,1,28555762,28556152,28555957,390
1601,181,2,10359455,10360089,10359772,634
1602,181,4,858562,858723,858642,161
1603,181,5,3200852,3202289,3201570,1437
1604,181,5,24771105,24771281,24771193,176
1605,182,1,7455275,7455344,7455309,69
1606,182,1,11471553,11472354,11471953,801
1607,182,1,12245989,12248745,12247367,2756
1608,182,1,20140665,20140682,20140673,17
1609,182,1,21179372,21181417,21180394,2045
1610,182,1,23344453,23345169,23344811,716
1611,182,1,24439216,24439387,24439301,171
1612,182,2,692944,694129,693536,1185
1613,182,2,1350067,1350313,1350190,246
1614,182,3,5631875,5632780,5632327,905
1615,182,3,16598649,16599738,16599193,1089
1616,182,4,216640,216718,216679,78
1617,182,4,886758,886929,886843,171
1618,182,4,5927451,5927504,5927477,53
1619,182,4,6486429,6486477,6486453,48
1620,182,4,6968934,6968952,6968943,18
1621,182,4,8086821,8086986,8086903,165
1622,182,4,9162117,9162204,9162160,87
1623,182,5,1921636,1922659,1922147,1023
1624,182,5,7168583,7168707,7168645,124
1625,182,5,7689828,7690450,7690139,622
1626,182,5,8393638,8393707,8393672,69
1627,182,5,15295722,15297096,15296409,1374
1628,182,5,17166776,17166784,17166780,8
1629,182,5,26020186,26020835,26020510,649
1630,183,1,8537446,8537508,8537477,62
1631,183,1,9128609,9129000,9128804,391
1632,183,1,19852213,19852841,19852527,628
1633,183,1,23354694,23354803,23354748,109
1634,183,2,11777167,11777295,11777231,128
1635,183,2,16582132,16582545,16582338,413
1636,183,2,19335348,19335584,19335466,236
1637,183,3,7983628,7985263,7984445,1635
1638,183,3,9282156,9283487,9282821,1331
1639,183,4,11839617,11839825,11839721,208
1640,183,5,1020525,1021394,1020959,869
1641,183,5,21721488,21722193,21721840,705
1642,184,1,1143291,1143337,1143314,46
1643,184,1,1936938,1939129,1938033,2191
1644,184,1,9500553,9501125,9500839,572
1645,184,1,12459022,12459037,12459029,15
1646,184,2,410258,410430,410344,172
1647,184,2,8458376,8458546,8458461,170
1648,184,2,9146565,9147225,9146895,660
1649,184,2,11264398,11264602,11264500,204
1650,184,2,12904473,12904676,12904574,203
1651,184,2,13410785,13410943,13410864,158
1652,184,2,18170309,18174768,18172538,4459
1653,184,3,18759870,18760273,18760071,403
1654,184,4,474314,476169,475241,1855
1655,184,4,7943762,7946025,7944893,2263
1656,184,4,16423449,16423900,16423674,451
1657,184,4,17044768,17047926,17046347,3158
1658,184,4,17606075,17606089,17606082,14
1659,184,4,18052125,18052343,18052234,218
1660,184,5,737541,737827,737684,286
1661,184,5,7198048,7198700,7198374,652
1662,184,5,10415678,10415933,10415805,255
1663,184,5,10905236,10905373,10905304,137
1664,184,5,14047872,14048036,14047954,164
1665,184,5,17349655,17349694,17349674,39
1666,184,5,21513895,21513972,21513933,77
1667,184,5,23073600,23073947,23073773,347
1668,184,5,24914141,24914775,24914458,634
1669,185,1,1773820,1774165,1773992,345
1670,185,1,4579030,4579913,4579471,883
1671,185,1,12019148,12021852,12020500,2704
1672,185,2,13208563,13209172,13208867,609
1673,185,2,18485961,18486004,18485982,43
1674,185,3,4750652,4754218,4752435,3566
1675,185,3,8918718,8919186,8918952,468
1676,185,4,76357,76409,76383,52
1677,185,4,6048436,6048505,6048470,69
1678,185,4,10176735,10176877,10176806,142
1679,185,5,8799898,8800294,8800096,396
1680,185,5,13870297,13870806,13870551,509
1681,186,1,1225411,1226551,1225981,1140
1682,186,1,30198596,30200615,30199605,2019
1683,186,2,18324703,18324900,18324801,197
1684,186,3,8234571,8234633,8234602,62
1685,186,3,19668458,19668875,19668666,417
1686,186,4,10321354,10321405,10321379,51
1687,186,5,16973124,16973461,16973292,337
1688,186,5,20212982,20213032,20213007,50
